newsDatetime,important,liked,disliked,positive,negative,code,net_sentiment,net_engagement,year,month,quarter
2019-03-05 10:33:30,7,7,0,7,1,BTC,6,7,2019,3,1
2019-03-05 16:01:13,3,4,0,5,0,BTC,5,4,2019,3,1
2019-03-10 13:19:32,12,18,3,16,3,BTC,13,15,2019,3,1
2019-03-15 14:45:21,16,20,0,25,0,BTC,25,20,2019,3,1
2019-04-04 11:42:37,10,12,0,16,0,BTC,16,12,2019,4,2
2019-04-13 13:02:15,27,37,0,30,0,BTC,30,37,2019,4,2
2019-04-15 15:06:59,6,7,0,6,0,BTC,6,7,2019,4,2
2019-04-27 19:30:41,13,26,0,27,0,BTC,27,26,2019,4,2
2019-04-29 06:30:03,9,15,1,16,1,BTC,15,14,2019,4,2
2019-05-06 12:55:06,3,0,0,0,1,BTC,-1,0,2019,5,2
2019-05-08 12:18:56,3,5,0,6,1,BTC,5,5,2019,5,2
2019-05-10 11:12:40,4,6,5,9,2,BTC,7,1,2019,5,2
2019-05-24 21:17:18,24,5,19,0,31,BTC,-31,-14,2019,5,2
2019-06-03 17:38:36,9,9,11,11,15,BTC,-4,-2,2019,6,2
2019-06-14 20:11:33,25,57,1,35,2,BTC,33,56,2019,6,2
2019-09-24 20:43:36,3,1,0,1,1,BTC,0,1,2019,9,3
2019-10-08 21:24:49,4,6,0,3,2,BTC,1,6,2019,10,4
2019-10-21 17:10:00,5,8,27,8,8,BTC,0,-19,2019,10,4
2019-10-30 12:04:47,5,8,11,7,13,BTC,-6,-3,2019,10,4
2019-11-01 07:20:38,3,5,3,5,2,BTC,3,2,2019,11,4
2019-11-14 21:00:46,3,3,0,3,0,BTC,3,3,2019,11,4
2019-12-26 08:20:14,12,26,0,24,0,BTC,24,26,2019,12,4
2020-01-27 10:30:03,7,10,0,10,0,BTC,10,10,2020,1,1
2020-01-27 17:50:00,3,10,0,9,0,BTC,9,10,2020,1,1
2020-02-14 12:50:37,4,6,0,6,0,BTC,6,6,2020,2,1
2020-07-28 16:00:23,16,20,0,26,0,BTC,26,20,2020,7,3
2020-08-09 18:21:31,7,9,2,10,1,BTC,9,7,2020,8,3
2020-09-05 21:07:55,5,3,1,2,3,BTC,-1,2,2020,9,3
2020-11-11 16:30:38,8,8,1,14,1,BTC,13,7,2020,11,4
2020-11-20 21:25:47,3,3,0,4,0,BTC,4,3,2020,11,4
2020-11-21 09:04:19,5,6,1,8,1,BTC,7,5,2020,11,4
2020-11-24 08:10:13,4,2,0,3,0,BTC,3,2,2020,11,4
2020-11-30 18:25:22,3,3,0,1,3,BTC,-2,3,2020,11,4
2020-12-03 13:45:21,11,12,1,18,0,BTC,18,11,2020,12,4
2020-12-09 14:46:02,3,5,0,7,0,BTC,7,5,2020,12,4
2020-12-09 22:59:01,3,3,0,3,0,BTC,3,3,2020,12,4
2020-12-10 12:23:16,13,15,0,17,1,BTC,16,15,2020,12,4
2020-12-12 19:30:45,17,24,0,26,0,BTC,26,24,2020,12,4
2020-12-23 23:00:04,4,3,0,0,5,BTC,-5,3,2020,12,4
2020-12-26 14:10:50,3,1,1,0,4,BTC,-4,0,2020,12,4
2020-12-29 22:00:51,4,1,1,0,4,BTC,-4,0,2020,12,4
2020-12-31 08:08:37,6,5,0,9,0,BTC,9,5,2020,12,4
2020-12-31 12:22:08,11,13,2,19,3,BTC,16,11,2020,12,4
2020-12-31 19:04:35,3,3,1,0,4,BTC,-4,2,2020,12,4
2020-12-31 20:47:13,3,6,0,6,4,BTC,2,6,2020,12,4
2021-01-05 14:48:21,5,6,0,1,3,BTC,-2,6,2021,1,1
2021-01-05 21:38:30,3,2,0,5,0,BTC,5,2,2021,1,1
2021-01-06 08:49:51,5,7,0,7,0,BTC,7,7,2021,1,1
2021-01-07 22:15:07,5,3,0,4,7,BTC,-3,3,2021,1,1
2021-01-11 14:26:18,3,1,7,1,11,BTC,-10,-6,2021,1,1
2021-01-12 12:00:10,14,15,0,23,1,BTC,22,15,2021,1,1
2021-01-12 19:28:42,12,18,0,29,0,BTC,29,18,2021,1,1
2021-01-13 07:28:11,3,5,0,7,0,BTC,7,5,2021,1,1
2021-01-15 09:16:20,3,2,1,2,0,BTC,2,1,2021,1,1
2021-01-15 19:49:05,4,10,0,9,0,BTC,9,10,2021,1,1
2021-01-16 10:01:51,3,6,0,10,0,BTC,10,6,2021,1,1
2021-01-16 14:37:33,3,2,0,2,0,BTC,2,2,2021,1,1
2021-01-21 06:17:00,4,4,2,3,6,BTC,-3,2,2021,1,1
2021-01-21 17:06:44,5,13,5,23,3,BTC,20,8,2021,1,1
2021-01-22 18:43:42,7,11,0,12,0,BTC,12,11,2021,1,1
2021-01-22 22:16:42,9,12,0,14,0,BTC,14,12,2021,1,1
2021-01-24 02:01:55,10,12,0,14,0,BTC,14,12,2021,1,1
2021-01-25 18:03:24,7,7,0,9,0,BTC,9,7,2021,1,1
2021-01-28 11:00:13,6,5,0,8,1,BTC,7,5,2021,1,1
2021-01-28 13:15:14,8,7,1,14,2,BTC,12,6,2021,1,1
2021-01-28 13:42:24,7,9,0,18,1,BTC,17,9,2021,1,1
2021-01-28 22:51:34,4,5,0,6,0,BTC,6,5,2021,1,1
2021-01-29 08:51:59,15,22,0,29,0,BTC,29,22,2021,1,1
2021-01-29 09:47:32,20,27,2,34,3,BTC,31,25,2021,1,1
2021-01-29 20:16:03,3,0,2,0,4,BTC,-4,-2,2021,1,1
2021-02-01 06:55:47,7,10,1,14,1,BTC,13,9,2021,2,1
2021-02-01 08:15:41,4,8,1,8,0,BTC,8,7,2021,2,1
2021-02-01 09:21:40,8,8,1,10,1,BTC,9,7,2021,2,1
2021-02-01 11:45:06,7,9,0,11,0,BTC,11,9,2021,2,1
2021-02-02 09:39:44,4,5,0,5,0,BTC,5,5,2021,2,1
2021-02-04 16:38:44,3,9,0,13,0,BTC,13,9,2021,2,1
2021-02-04 21:36:44,4,6,0,6,1,BTC,5,6,2021,2,1
2021-02-05 14:17:45,4,4,0,7,0,BTC,7,4,2021,2,1
2021-02-05 18:52:21,13,17,0,20,1,BTC,19,17,2021,2,1
2021-02-07 14:28:58,13,26,1,30,0,BTC,30,25,2021,2,1
2021-02-08 10:47:55,14,16,1,25,1,BTC,24,15,2021,2,1
2021-02-08 13:30:19,16,23,0,29,0,BTC,29,23,2021,2,1
2021-02-09 15:59:25,4,3,0,5,0,BTC,5,3,2021,2,1
2021-02-10 00:13:37,3,4,0,5,0,BTC,5,4,2021,2,1
2021-02-10 11:08:00,4,4,2,10,0,BTC,10,2,2021,2,1
2021-02-11 14:35:37,5,8,4,9,2,BTC,7,4,2021,2,1
2021-02-12 16:19:00,6,8,5,6,2,BTC,4,3,2021,2,1
2021-02-13 08:04:31,3,7,0,7,0,BTC,7,7,2021,2,1
2021-02-13 17:30:41,23,34,0,42,0,BTC,42,34,2021,2,1
2021-02-14 04:58:47,7,13,1,12,1,BTC,11,12,2021,2,1
2021-02-14 13:29:36,3,5,0,7,0,BTC,7,5,2021,2,1
2021-02-15 03:18:37,5,5,0,6,3,BTC,3,5,2021,2,1
2021-02-15 14:35:16,3,3,0,3,0,BTC,3,3,2021,2,1
2021-02-16 09:15:41,7,16,1,17,2,BTC,15,15,2021,2,1
2021-02-16 13:29:12,10,20,0,24,0,BTC,24,20,2021,2,1
2021-02-16 19:29:43,9,13,3,15,4,BTC,11,10,2021,2,1
2021-02-17 12:09:30,4,4,0,3,0,BTC,3,4,2021,2,1
2021-02-17 17:30:24,5,8,17,6,25,BTC,-19,-9,2021,2,1
2021-02-18 20:00:58,3,4,0,3,0,BTC,3,4,2021,2,1
2021-02-19 09:35:46,15,23,1,30,1,BTC,29,22,2021,2,1
2021-02-19 11:00:18,3,0,2,2,4,BTC,-2,-2,2021,2,1
2021-02-19 11:39:27,17,23,22,33,22,BTC,11,1,2021,2,1
2021-02-19 17:24:07,15,17,1,17,1,BTC,16,16,2021,2,1
2021-02-19 17:58:33,3,3,1,3,0,BTC,3,2,2021,2,1
2021-02-19 19:24:30,12,14,0,14,0,BTC,14,14,2021,2,1
2021-02-19 21:00:17,11,26,1,18,0,BTC,18,25,2021,2,1
2021-02-19 22:15:50,3,5,0,7,0,BTC,7,5,2021,2,1
2021-02-20 04:40:45,3,5,0,4,0,BTC,4,5,2021,2,1
2021-02-20 09:11:51,5,7,0,10,0,BTC,10,7,2021,2,1
2021-02-20 12:00:05,4,6,0,6,0,BTC,6,6,2021,2,1
2021-02-21 14:36:01,16,16,26,25,22,BTC,3,-10,2021,2,1
2021-02-21 19:45:01,3,8,0,8,0,BTC,8,8,2021,2,1
2021-02-21 22:15:28,8,15,8,17,10,BTC,7,7,2021,2,1
2021-02-22 12:54:15,4,1,3,0,8,BTC,-8,-2,2021,2,1
2021-02-22 21:34:58,4,6,3,8,11,BTC,-3,3,2021,2,1
2021-02-23 07:59:55,7,2,5,5,21,BTC,-16,-3,2021,2,1
2021-02-23 12:59:00,23,26,2,36,3,BTC,33,24,2021,2,1
2021-02-23 13:55:49,4,4,0,6,0,BTC,6,4,2021,2,1
2021-02-23 20:00:08,3,4,5,7,12,BTC,-5,-1,2021,2,1
2021-02-24 20:14:34,3,2,0,4,0,BTC,4,2,2021,2,1
2021-02-24 21:35:49,5,7,3,13,5,BTC,8,4,2021,2,1
2021-02-25 03:49:00,4,3,0,4,1,BTC,3,3,2021,2,1
2021-02-25 23:09:45,4,6,1,5,1,BTC,4,5,2021,2,1
2021-02-26 09:08:50,23,36,3,47,5,BTC,42,33,2021,2,1
2021-02-26 14:15:24,16,17,2,24,1,BTC,23,15,2021,2,1
2021-02-26 16:32:17,19,29,0,34,1,BTC,33,29,2021,2,1
2021-02-26 18:51:28,6,8,0,8,0,BTC,8,8,2021,2,1
2021-02-28 12:45:54,3,5,2,6,0,BTC,6,3,2021,2,1
2021-03-01 12:18:13,8,13,0,18,0,BTC,18,13,2021,3,1
2021-03-02 08:40:34,3,5,0,5,0,BTC,5,5,2021,3,1
2021-03-02 11:00:49,5,10,2,17,0,BTC,17,8,2021,3,1
2021-03-02 17:11:14,8,11,1,24,0,BTC,24,10,2021,3,1
2021-03-02 18:06:33,5,10,0,8,0,BTC,8,10,2021,3,1
2021-03-02 20:00:28,3,10,2,9,0,BTC,9,8,2021,3,1
2021-03-03 11:23:58,3,3,0,4,0,BTC,4,3,2021,3,1
2021-03-04 14:41:35,23,2,9,3,37,BTC,-34,-7,2021,3,1
2021-03-05 03:20:00,16,22,1,19,2,BTC,17,21,2021,3,1
2021-03-05 07:02:56,7,7,3,9,5,BTC,4,4,2021,3,1
2021-03-06 13:29:00,4,5,0,6,0,BTC,6,5,2021,3,1
2021-03-07 08:04:22,3,7,0,7,0,BTC,7,7,2021,3,1
2021-03-07 15:57:36,3,4,0,6,0,BTC,6,4,2021,3,1
2021-03-07 19:36:15,6,20,1,17,0,BTC,17,19,2021,3,1
2021-03-08 10:00:49,4,4,0,6,0,BTC,6,4,2021,3,1
2021-03-08 21:26:06,7,8,0,7,0,BTC,7,8,2021,3,1
2021-03-09 09:28:50,4,8,1,11,1,BTC,10,7,2021,3,1
2021-03-09 09:41:42,4,0,2,0,5,BTC,-5,-2,2021,3,1
2021-03-10 03:28:34,4,4,0,3,0,BTC,3,4,2021,3,1
2021-03-11 20:59:05,3,5,0,5,0,BTC,5,5,2021,3,1
2021-03-12 01:21:00,3,3,0,4,0,BTC,4,3,2021,3,1
2021-03-12 11:52:54,11,12,1,22,1,BTC,21,11,2021,3,1
2021-03-12 14:00:30,3,1,0,3,1,BTC,2,1,2021,3,1
2021-03-12 16:19:00,8,9,9,9,19,BTC,-10,0,2021,3,1
2021-03-14 19:20:00,5,11,2,9,1,BTC,8,9,2021,3,1
2021-03-15 10:00:03,22,11,1,16,4,BTC,12,10,2021,3,1
2021-03-17 14:15:04,4,4,0,4,0,BTC,4,4,2021,3,1
2021-03-17 15:27:38,3,5,0,5,1,BTC,4,5,2021,3,1
2021-03-17 15:50:16,9,14,0,22,0,BTC,22,14,2021,3,1
2021-03-17 16:35:05,5,5,0,5,0,BTC,5,5,2021,3,1
2021-03-17 19:25:00,13,20,0,28,0,BTC,28,20,2021,3,1
2021-03-17 21:30:00,3,3,0,4,0,BTC,4,3,2021,3,1
2021-03-17 23:22:47,10,18,0,23,0,BTC,23,18,2021,3,1
2021-03-19 10:19:00,3,11,0,16,0,BTC,16,11,2021,3,1
2021-03-19 23:09:25,4,6,0,6,0,BTC,6,6,2021,3,1
2021-03-20 08:39:42,3,6,0,7,0,BTC,7,6,2021,3,1
2021-03-20 09:21:00,18,9,4,4,16,BTC,-12,5,2021,3,1
2021-03-20 11:19:07,7,10,0,10,0,BTC,10,10,2021,3,1
2021-03-20 11:54:03,5,3,0,0,4,BTC,-4,3,2021,3,1
2021-03-20 14:00:22,6,14,0,11,0,BTC,11,14,2021,3,1
2021-03-21 06:21:14,4,13,29,11,3,BTC,8,-16,2021,3,1
2021-03-21 12:11:08,3,9,0,12,1,BTC,11,9,2021,3,1
2021-03-21 13:45:27,4,6,1,6,1,BTC,5,5,2021,3,1
2021-03-21 19:00:42,11,12,3,14,5,BTC,9,9,2021,3,1
2021-03-21 20:29:11,10,17,0,21,0,BTC,21,17,2021,3,1
2021-03-22 10:50:41,3,6,1,5,0,BTC,5,5,2021,3,1
2021-03-23 07:08:58,7,7,0,8,0,BTC,8,7,2021,3,1
2021-03-24 07:16:43,11,22,0,28,0,BTC,28,22,2021,3,1
2021-03-24 09:05:31,3,7,0,10,0,BTC,10,7,2021,3,1
2021-03-24 16:43:08,4,3,0,3,3,BTC,0,3,2021,3,1
2021-03-24 21:01:43,3,4,0,2,0,BTC,2,4,2021,3,1
2021-03-25 09:10:42,11,16,5,24,2,BTC,22,11,2021,3,1
2021-03-25 13:28:40,3,4,0,6,1,BTC,5,4,2021,3,1
2021-03-25 15:18:51,8,8,0,10,3,BTC,7,8,2021,3,1
2021-03-25 18:33:49,4,5,0,9,2,BTC,7,5,2021,3,1
2021-03-26 11:28:13,6,6,0,6,4,BTC,2,6,2021,3,1
2021-03-28 16:10:51,23,37,0,47,0,BTC,47,37,2021,3,1
2021-03-28 20:35:34,27,22,0,31,0,BTC,31,22,2021,3,1
2021-03-29 07:22:46,3,6,0,5,0,BTC,5,6,2021,3,1
2021-03-29 09:00:00,18,30,0,40,0,BTC,40,30,2021,3,1
2021-03-29 09:52:53,10,17,0,20,0,BTC,20,17,2021,3,1
2021-03-29 12:22:53,5,7,0,7,0,BTC,7,7,2021,3,1
2021-03-29 13:26:39,9,13,1,22,0,BTC,22,12,2021,3,1
2021-03-29 13:42:56,7,14,0,20,0,BTC,20,14,2021,3,1
2021-03-29 18:53:45,3,4,0,6,0,BTC,6,4,2021,3,1
2021-03-30 12:19:00,6,8,0,9,0,BTC,9,8,2021,3,1
2021-03-30 14:10:00,27,40,0,58,0,BTC,58,40,2021,3,1
2021-03-30 16:52:43,7,8,0,8,0,BTC,8,8,2021,3,1
2021-03-30 20:58:04,4,4,6,5,4,BTC,1,-2,2021,3,1
2021-03-31 08:48:32,3,4,3,3,2,BTC,1,1,2021,3,1
2021-03-31 09:44:38,4,4,1,5,2,BTC,3,3,2021,3,1
2021-03-31 18:44:56,3,5,0,4,0,BTC,4,5,2021,3,1
2021-04-01 09:50:59,3,1,12,1,4,BTC,-3,-11,2021,4,2
2021-04-02 09:23:43,5,11,0,11,0,BTC,11,11,2021,4,2
2021-04-02 18:35:00,3,8,1,9,1,BTC,8,7,2021,4,2
2021-04-02 19:06:31,4,11,1,16,4,BTC,12,10,2021,4,2
2021-04-02 19:14:20,7,8,1,19,1,BTC,18,7,2021,4,2
2021-04-03 10:18:08,3,8,0,5,1,BTC,4,8,2021,4,2
2021-04-05 08:25:20,5,12,0,25,1,BTC,24,12,2021,4,2
2021-04-05 21:40:00,3,4,1,5,1,BTC,4,3,2021,4,2
2021-04-06 00:58:15,3,5,1,3,1,BTC,2,4,2021,4,2
2021-04-06 07:24:06,4,2,1,1,1,BTC,0,1,2021,4,2
2021-04-06 14:30:12,5,5,1,6,2,BTC,4,4,2021,4,2
2021-04-06 20:00:37,3,4,1,6,2,BTC,4,3,2021,4,2
2021-04-06 20:56:54,3,5,0,4,0,BTC,4,5,2021,4,2
2021-04-07 04:35:27,4,8,1,7,1,BTC,6,7,2021,4,2
2021-04-07 09:03:00,5,7,2,9,2,BTC,7,5,2021,4,2
2021-04-07 09:39:32,3,5,2,3,2,BTC,1,3,2021,4,2
2021-04-07 20:52:15,7,13,3,11,1,BTC,10,10,2021,4,2
2021-04-08 10:22:00,15,23,2,39,2,BTC,37,21,2021,4,2
2021-04-08 13:56:42,6,10,9,16,17,BTC,-1,1,2021,4,2
2021-04-08 14:02:39,10,13,0,22,0,BTC,22,13,2021,4,2
2021-04-08 14:30:56,3,4,2,5,1,BTC,4,2,2021,4,2
2021-04-08 15:46:11,16,29,0,35,1,BTC,34,29,2021,4,2
2021-04-08 16:30:15,6,8,0,10,0,BTC,10,8,2021,4,2
2021-04-08 17:30:05,3,9,3,12,3,BTC,9,6,2021,4,2
2021-04-08 18:45:08,14,25,1,39,0,BTC,39,24,2021,4,2
2021-04-09 11:31:48,18,26,3,38,0,BTC,38,23,2021,4,2
2021-04-09 13:12:28,3,1,2,0,3,BTC,-3,-1,2021,4,2
2021-04-09 14:33:29,23,33,2,43,4,BTC,39,31,2021,4,2
2021-04-09 18:15:49,16,22,2,27,2,BTC,25,20,2021,4,2
2021-04-10 06:57:05,12,17,0,24,0,BTC,24,17,2021,4,2
2021-04-10 20:23:33,9,18,4,19,4,BTC,15,14,2021,4,2
2021-04-12 13:07:39,3,5,1,5,1,BTC,4,4,2021,4,2
2021-04-12 17:30:53,3,6,0,7,0,BTC,7,6,2021,4,2
2021-04-12 18:35:08,6,12,1,3,11,BTC,-8,11,2021,4,2
2021-04-12 20:44:48,4,8,1,5,0,BTC,5,7,2021,4,2
2021-04-12 21:21:36,14,17,0,19,0,BTC,19,17,2021,4,2
2021-04-13 09:28:38,3,2,1,2,1,BTC,1,1,2021,4,2
2021-04-13 11:23:35,14,15,0,26,0,BTC,26,15,2021,4,2
2021-04-14 05:27:00,7,17,0,27,1,BTC,26,17,2021,4,2
2021-04-14 21:12:59,3,2,0,5,0,BTC,5,2,2021,4,2
2021-04-15 16:30:01,6,7,45,12,15,BTC,-3,-38,2021,4,2
2021-04-15 16:47:46,3,6,1,5,1,BTC,4,5,2021,4,2
2021-04-15 21:14:16,14,28,7,42,5,BTC,37,21,2021,4,2
2021-04-16 07:26:11,3,10,14,10,17,BTC,-7,-4,2021,4,2
2021-04-16 11:52:29,16,7,37,8,21,BTC,-13,-30,2021,4,2
2021-04-16 15:11:23,3,10,18,11,24,BTC,-13,-8,2021,4,2
2021-04-17 09:53:09,9,18,12,19,11,BTC,8,6,2021,4,2
2021-04-17 16:02:36,8,13,2,23,3,BTC,20,11,2021,4,2
2021-04-17 20:00:52,7,12,45,10,36,BTC,-26,-33,2021,4,2
2021-04-18 07:04:32,4,6,1,8,0,BTC,8,5,2021,4,2
2021-04-18 07:29:21,6,13,9,17,4,BTC,13,4,2021,4,2
2021-04-18 09:54:27,3,1,1,3,3,BTC,0,0,2021,4,2
2021-04-18 14:56:29,6,8,6,0,16,BTC,-16,2,2021,4,2
2021-04-18 23:10:00,5,3,17,4,12,BTC,-8,-14,2021,4,2
2021-04-19 07:19:15,9,21,2,30,1,BTC,29,19,2021,4,2
2021-04-19 10:44:59,10,11,18,19,14,BTC,5,-7,2021,4,2
2021-04-19 12:00:58,5,17,14,23,20,BTC,3,3,2021,4,2
2021-04-19 15:11:05,11,20,1,26,2,BTC,24,19,2021,4,2
2021-04-19 15:46:56,5,18,8,24,9,BTC,15,10,2021,4,2
2021-04-19 17:38:11,6,14,0,18,0,BTC,18,14,2021,4,2
2021-04-19 20:00:49,4,16,7,10,17,BTC,-7,9,2021,4,2
2021-04-19 20:01:53,11,22,16,28,22,BTC,6,6,2021,4,2
2021-04-20 04:21:00,7,15,7,23,4,BTC,19,8,2021,4,2
2021-04-20 04:55:40,15,25,12,38,14,BTC,24,13,2021,4,2
2021-04-20 06:25:30,5,15,13,20,15,BTC,5,2,2021,4,2
2021-04-20 07:18:44,3,7,5,10,4,BTC,6,2,2021,4,2
2021-04-20 08:20:00,9,6,19,10,22,BTC,-12,-13,2021,4,2
2021-04-20 11:01:53,4,6,0,12,0,BTC,12,6,2021,4,2
2021-04-20 14:28:59,18,35,1,42,0,BTC,42,34,2021,4,2
2021-04-21 07:32:00,4,4,0,3,0,BTC,3,4,2021,4,2
2021-04-21 21:02:28,3,7,3,6,4,BTC,2,4,2021,4,2
2021-04-22 07:04:01,3,2,2,3,2,BTC,1,0,2021,4,2
2021-04-22 08:08:57,10,25,0,36,2,BTC,34,25,2021,4,2
2021-04-22 08:45:08,22,15,0,19,1,BTC,18,15,2021,4,2
2021-04-22 10:04:55,4,11,3,8,6,BTC,2,8,2021,4,2
2021-04-22 10:20:00,3,4,0,5,0,BTC,5,4,2021,4,2
2021-04-22 14:31:35,21,30,3,28,5,BTC,23,27,2021,4,2
2021-04-22 23:40:43,7,9,1,10,1,BTC,9,8,2021,4,2
2021-04-23 05:30:00,3,1,1,1,1,BTC,0,0,2021,4,2
2021-04-23 19:17:13,4,9,0,9,0,BTC,9,9,2021,4,2
2021-04-23 20:36:30,3,5,0,3,0,BTC,3,5,2021,4,2
2021-04-24 06:10:35,6,21,4,22,2,BTC,20,17,2021,4,2
2021-04-24 09:30:20,16,24,5,33,4,BTC,29,19,2021,4,2
2021-04-24 10:47:42,16,18,1,26,1,BTC,25,17,2021,4,2
2021-04-24 16:00:00,3,2,1,1,1,BTC,0,1,2021,4,2
2021-04-25 17:03:25,12,22,0,19,0,BTC,19,22,2021,4,2
2021-04-25 21:19:18,5,18,0,4,0,BTC,4,18,2021,4,2
2021-04-26 10:30:18,8,23,0,25,0,BTC,25,23,2021,4,2
2021-04-26 20:30:11,18,19,3,30,23,BTC,7,16,2021,4,2
2021-04-26 21:15:00,12,18,2,24,16,BTC,8,16,2021,4,2
2021-04-27 08:27:57,24,27,6,5,40,BTC,-35,21,2021,4,2
2021-04-27 19:12:03,5,22,2,21,2,BTC,19,20,2021,4,2
2021-04-27 21:00:21,3,3,1,0,0,BTC,0,2,2021,4,2
2021-04-28 00:00:11,4,7,0,5,0,BTC,5,7,2021,4,2
2021-04-28 05:59:06,3,6,0,5,0,BTC,5,6,2021,4,2
2021-04-28 08:09:53,18,25,0,37,0,BTC,37,25,2021,4,2
2021-04-28 08:16:17,4,4,0,11,0,BTC,11,4,2021,4,2
2021-04-28 10:45:19,30,4,14,3,21,BTC,-18,-10,2021,4,2
2021-04-28 10:52:40,9,16,19,22,17,BTC,5,-3,2021,4,2
2021-04-28 18:18:08,9,13,0,17,0,BTC,17,13,2021,4,2
2021-04-29 13:58:48,3,5,0,5,0,BTC,5,5,2021,4,2
2021-04-29 15:34:02,9,12,0,17,0,BTC,17,12,2021,4,2
2021-04-29 20:00:08,8,18,0,23,1,BTC,22,18,2021,4,2
2021-04-30 05:16:07,3,8,1,8,1,BTC,7,7,2021,4,2
2021-04-30 13:22:36,3,6,0,3,0,BTC,3,6,2021,4,2
2021-05-01 07:04:16,3,7,0,10,0,BTC,10,7,2021,5,2
2021-05-01 13:42:21,8,27,1,27,0,BTC,27,26,2021,5,2
2021-05-01 13:55:53,3,5,0,6,0,BTC,6,5,2021,5,2
2021-05-01 18:45:32,26,63,1,52,2,BTC,50,62,2021,5,2
2021-05-02 11:30:00,9,18,0,19,0,BTC,19,18,2021,5,2
2021-05-03 16:15:19,8,9,2,13,2,BTC,11,7,2021,5,2
2021-05-04 15:10:30,4,4,3,7,2,BTC,5,1,2021,5,2
2021-05-04 15:30:44,9,5,1,7,9,BTC,-2,4,2021,5,2
2021-05-05 07:01:26,5,9,8,13,4,BTC,9,1,2021,5,2
2021-05-05 07:24:40,7,19,0,19,1,BTC,18,19,2021,5,2
2021-05-05 09:10:00,5,11,13,13,16,BTC,-3,-2,2021,5,2
2021-05-05 16:00:45,7,7,0,6,0,BTC,6,7,2021,5,2
2021-05-05 17:49:16,9,22,16,19,18,BTC,1,6,2021,5,2
2021-05-06 08:39:38,9,9,0,13,1,BTC,12,9,2021,5,2
2021-05-06 09:56:05,4,7,0,10,0,BTC,10,7,2021,5,2
2021-05-06 23:31:58,8,16,0,26,0,BTC,26,16,2021,5,2
2021-05-07 07:15:00,14,24,1,32,0,BTC,32,23,2021,5,2
2021-05-07 15:16:43,3,1,0,5,1,BTC,4,1,2021,5,2
2021-05-08 01:55:23,3,5,2,5,1,BTC,4,3,2021,5,2
2021-05-08 10:10:00,7,8,6,11,5,BTC,6,2,2021,5,2
2021-05-09 04:33:00,8,13,6,21,8,BTC,13,7,2021,5,2
2021-05-09 07:50:28,8,15,3,10,11,BTC,-1,12,2021,5,2
2021-05-09 11:39:38,11,15,9,12,6,BTC,6,6,2021,5,2
2021-05-09 17:58:29,15,28,2,31,2,BTC,29,26,2021,5,2
2021-05-10 09:08:43,5,6,6,6,4,BTC,2,0,2021,5,2
2021-05-10 13:00:09,10,27,0,28,1,BTC,27,27,2021,5,2
2021-05-10 13:40:19,3,3,0,5,1,BTC,4,3,2021,5,2
2021-05-10 21:20:00,5,2,1,0,3,BTC,-3,1,2021,5,2
2021-05-11 03:08:57,3,1,0,0,0,BTC,0,1,2021,5,2
2021-05-11 08:05:13,11,18,0,26,0,BTC,26,18,2021,5,2
2021-05-11 08:56:20,7,25,8,25,12,BTC,13,17,2021,5,2
2021-05-11 09:09:40,3,6,10,15,5,BTC,10,-4,2021,5,2
2021-05-11 09:51:13,6,6,0,9,0,BTC,9,6,2021,5,2
2021-05-11 10:12:50,20,33,6,26,7,BTC,19,27,2021,5,2
2021-05-11 14:12:38,4,6,8,16,11,BTC,5,-2,2021,5,2
2021-05-12 03:59:21,6,10,3,16,4,BTC,12,7,2021,5,2
2021-05-12 12:23:59,3,4,0,4,0,BTC,4,4,2021,5,2
2021-05-13 05:32:00,10,20,7,24,1,BTC,23,13,2021,5,2
2021-05-13 16:30:01,5,6,1,6,0,BTC,6,5,2021,5,2
2021-05-13 18:33:51,7,12,2,17,0,BTC,17,10,2021,5,2
2021-05-13 19:51:24,8,7,1,7,0,BTC,7,6,2021,5,2
2021-05-13 21:05:44,41,84,1,92,2,BTC,90,83,2021,5,2
2021-05-13 22:55:21,5,13,3,16,1,BTC,15,10,2021,5,2
2021-05-14 00:08:13,4,2,1,3,2,BTC,1,1,2021,5,2
2021-05-14 06:50:00,9,20,22,19,22,BTC,-3,-2,2021,5,2
2021-05-14 07:15:21,3,4,1,8,0,BTC,8,3,2021,5,2
2021-05-14 07:50:17,5,3,9,3,9,BTC,-6,-6,2021,5,2
2021-05-14 09:21:07,3,5,5,3,0,BTC,3,0,2021,5,2
2021-05-14 10:36:21,6,14,1,14,0,BTC,14,13,2021,5,2
2021-05-14 11:46:04,29,53,9,61,6,BTC,55,44,2021,5,2
2021-05-14 12:30:08,3,5,1,6,1,BTC,5,4,2021,5,2
2021-05-14 22:05:41,3,4,0,5,0,BTC,5,4,2021,5,2
2021-05-15 10:12:04,3,4,0,3,0,BTC,3,4,2021,5,2
2021-05-15 10:23:42,14,21,73,40,34,BTC,6,-52,2021,5,2
2021-05-15 11:45:17,4,5,1,4,1,BTC,3,4,2021,5,2
2021-05-15 12:19:12,18,21,28,36,19,BTC,17,-7,2021,5,2
2021-05-15 18:29:34,16,39,1,50,2,BTC,48,38,2021,5,2
2021-05-15 19:30:38,6,6,0,5,0,BTC,5,6,2021,5,2
2021-05-16 04:19:00,4,9,4,3,2,BTC,1,5,2021,5,2
2021-05-16 04:52:00,8,12,47,17,36,BTC,-19,-35,2021,5,2
2021-05-16 06:00:40,5,11,43,11,43,BTC,-32,-32,2021,5,2
2021-05-16 07:15:43,9,19,7,25,4,BTC,21,12,2021,5,2
2021-05-16 18:02:00,13,16,57,20,59,BTC,-39,-41,2021,5,2
2021-05-16 19:39:01,6,16,0,23,0,BTC,23,16,2021,5,2
2021-05-16 20:55:06,20,20,96,33,87,BTC,-54,-76,2021,5,2
2021-05-17 10:29:56,3,6,2,4,0,BTC,4,4,2021,5,2
2021-05-17 15:52:06,8,18,0,24,0,BTC,24,18,2021,5,2
2021-05-17 20:33:51,14,19,24,25,17,BTC,8,-5,2021,5,2
2021-05-17 21:49:00,5,10,5,9,11,BTC,-2,5,2021,5,2
2021-05-18 07:16:50,3,15,2,6,2,BTC,4,13,2021,5,2
2021-05-18 07:20:49,9,16,0,21,0,BTC,21,16,2021,5,2
2021-05-18 16:00:45,4,9,0,10,0,BTC,10,9,2021,5,2
2021-05-18 19:46:43,4,6,0,10,0,BTC,10,6,2021,5,2
2021-05-19 03:09:50,21,19,1,27,4,BTC,23,18,2021,5,2
2021-05-19 13:20:00,3,5,0,7,0,BTC,7,5,2021,5,2
2021-05-20 16:05:59,20,34,15,25,22,BTC,3,19,2021,5,2
2021-05-20 21:10:17,44,75,0,99,1,BTC,98,75,2021,5,2
2021-05-21 23:00:56,3,4,1,4,0,BTC,4,3,2021,5,2
2021-05-22 14:00:52,4,12,0,14,0,BTC,14,12,2021,5,2
2021-05-22 16:00:41,20,37,3,45,1,BTC,44,34,2021,5,2
2021-05-23 04:38:40,4,14,13,5,21,BTC,-16,1,2021,5,2
2021-05-23 10:18:54,9,6,9,11,18,BTC,-7,-3,2021,5,2
2021-05-23 14:59:30,3,2,4,0,10,BTC,-10,-2,2021,5,2
2021-05-23 23:30:53,11,13,4,23,10,BTC,13,9,2021,5,2
2021-05-24 07:47:48,6,11,8,18,6,BTC,12,3,2021,5,2
2021-05-24 08:17:29,3,5,1,6,1,BTC,5,4,2021,5,2
2021-05-24 08:20:10,25,43,0,64,3,BTC,61,43,2021,5,2
2021-05-24 13:30:51,3,3,0,5,0,BTC,5,3,2021,5,2
2021-05-25 15:14:45,32,53,1,76,0,BTC,76,52,2021,5,2
2021-05-26 07:46:04,3,8,0,11,0,BTC,11,8,2021,5,2
2021-05-26 10:52:08,5,6,0,6,0,BTC,6,6,2021,5,2
2021-05-26 14:46:00,6,10,13,17,9,BTC,8,-3,2021,5,2
2021-05-26 19:24:22,3,6,0,11,4,BTC,7,6,2021,5,2
2021-05-27 08:34:11,3,5,0,4,5,BTC,-1,5,2021,5,2
2021-05-27 18:17:23,5,14,0,16,0,BTC,16,14,2021,5,2
2021-05-27 21:41:19,3,4,2,2,1,BTC,1,2,2021,5,2
2021-05-27 21:50:00,23,38,1,46,2,BTC,44,37,2021,5,2
2021-05-28 10:25:35,4,8,0,11,5,BTC,6,8,2021,5,2
2021-05-28 14:13:37,3,0,1,0,3,BTC,-3,-1,2021,5,2
2021-05-28 22:30:23,4,6,4,4,2,BTC,2,2,2021,5,2
2021-05-29 01:58:49,16,22,1,33,2,BTC,31,21,2021,5,2
2021-05-29 06:39:38,4,6,0,7,0,BTC,7,6,2021,5,2
2021-05-29 07:19:53,17,34,2,27,1,BTC,26,32,2021,5,2
2021-05-29 22:05:11,6,9,0,12,0,BTC,12,9,2021,5,2
2021-05-29 23:10:30,4,10,31,12,24,BTC,-12,-21,2021,5,2
2021-05-30 11:59:00,5,15,18,25,19,BTC,6,-3,2021,5,2
2021-05-30 14:36:13,4,5,0,8,0,BTC,8,5,2021,5,2
2021-05-30 14:44:59,5,6,0,8,0,BTC,8,6,2021,5,2
2021-05-30 18:06:39,5,11,0,8,0,BTC,8,11,2021,5,2
2021-05-31 17:21:21,11,7,31,10,38,BTC,-28,-24,2021,5,2
2021-05-31 18:45:55,4,6,0,7,0,BTC,7,6,2021,5,2
2021-05-31 21:20:00,29,43,2,57,3,BTC,54,41,2021,5,2
2021-05-31 22:15:00,3,13,7,25,9,BTC,16,6,2021,5,2
2021-06-01 09:00:00,3,0,5,5,1,BTC,4,-5,2021,6,2
2021-06-01 17:13:00,35,69,1,92,4,BTC,88,68,2021,6,2
2021-06-01 22:16:01,3,6,1,7,0,BTC,7,5,2021,6,2
2021-06-02 08:23:50,5,21,0,21,0,BTC,21,21,2021,6,2
2021-06-02 17:00:00,15,17,38,22,35,BTC,-13,-21,2021,6,2
2021-06-02 17:15:27,4,7,0,9,1,BTC,8,7,2021,6,2
2021-06-02 19:05:00,3,5,0,7,0,BTC,7,5,2021,6,2
2021-06-03 05:36:25,3,3,0,10,1,BTC,9,3,2021,6,2
2021-06-03 11:51:54,7,2,0,4,0,BTC,4,2,2021,6,2
2021-06-03 15:00:05,6,15,9,23,9,BTC,14,6,2021,6,2
2021-06-03 19:59:47,3,5,0,4,0,BTC,4,5,2021,6,2
2021-06-04 00:51:54,4,0,0,1,1,BTC,0,0,2021,6,2
2021-06-04 04:25:00,17,14,55,18,54,BTC,-36,-41,2021,6,2
2021-06-04 09:18:43,11,25,0,40,5,BTC,35,25,2021,6,2
2021-06-04 14:33:00,6,20,4,25,1,BTC,24,16,2021,6,2
2021-06-05 04:13:25,3,7,0,6,0,BTC,6,7,2021,6,2
2021-06-05 07:35:18,5,7,21,13,18,BTC,-5,-14,2021,6,2
2021-06-05 09:48:28,3,5,6,8,7,BTC,1,-1,2021,6,2
2021-06-05 15:10:28,4,8,0,8,0,BTC,8,8,2021,6,2
2021-06-05 15:30:25,3,1,9,2,16,BTC,-14,-8,2021,6,2
2021-06-05 17:11:00,5,9,0,8,1,BTC,7,9,2021,6,2
2021-06-05 23:00:00,7,16,4,14,11,BTC,3,12,2021,6,2
2021-06-06 10:40:00,4,9,4,5,5,BTC,0,5,2021,6,2
2021-06-06 11:40:14,6,16,0,14,1,BTC,13,16,2021,6,2
2021-06-06 16:00:30,3,4,0,4,0,BTC,4,4,2021,6,2
2021-06-06 18:58:52,15,36,1,35,1,BTC,34,35,2021,6,2
2021-06-06 20:43:38,45,70,6,77,8,BTC,69,64,2021,6,2
2021-06-07 07:18:44,10,31,5,37,6,BTC,31,26,2021,6,2
2021-06-07 10:19:39,3,3,0,5,0,BTC,5,3,2021,6,2
2021-06-07 18:11:30,4,6,0,7,1,BTC,6,6,2021,6,2
2021-06-07 18:20:00,4,5,1,6,1,BTC,5,4,2021,6,2
2021-06-08 01:56:55,13,17,8,18,28,BTC,-10,9,2021,6,2
2021-06-08 06:19:28,8,5,7,4,22,BTC,-18,-2,2021,6,2
2021-06-08 06:23:45,3,6,0,6,1,BTC,5,6,2021,6,2
2021-06-08 07:44:19,7,7,0,9,0,BTC,9,7,2021,6,2
2021-06-08 11:54:07,3,5,1,4,2,BTC,2,4,2021,6,2
2021-06-08 12:18:40,9,14,3,16,17,BTC,-1,11,2021,6,2
2021-06-08 13:00:56,7,8,1,8,0,BTC,8,7,2021,6,2
2021-06-08 20:24:28,5,17,1,26,0,BTC,26,16,2021,6,2
2021-06-09 02:00:35,3,3,1,5,1,BTC,4,2,2021,6,2
2021-06-09 22:05:17,25,39,3,45,0,BTC,45,36,2021,6,2
2021-06-10 18:00:06,5,11,0,6,0,BTC,6,11,2021,6,2
2021-06-10 20:02:03,5,7,1,9,1,BTC,8,6,2021,6,2
2021-06-11 07:40:00,18,36,14,70,8,BTC,62,22,2021,6,2
2021-06-11 18:27:17,7,10,2,14,1,BTC,13,8,2021,6,2
2021-06-11 22:05:57,40,73,2,73,3,BTC,70,71,2021,6,2
2021-06-12 07:17:13,11,8,8,6,31,BTC,-25,0,2021,6,2
2021-06-12 16:17:46,8,3,0,1,0,BTC,1,3,2021,6,2
2021-06-12 22:30:00,22,46,8,65,5,BTC,60,38,2021,6,2
2021-06-13 07:31:03,3,10,0,12,0,BTC,12,10,2021,6,2
2021-06-13 09:00:52,7,7,0,10,2,BTC,8,7,2021,6,2
2021-06-13 19:40:59,4,5,0,5,0,BTC,5,5,2021,6,2
2021-06-14 09:32:12,4,3,1,4,1,BTC,3,2,2021,6,2
2021-06-14 11:15:31,3,2,0,2,0,BTC,2,2,2021,6,2
2021-06-14 19:45:35,5,9,0,7,0,BTC,7,9,2021,6,2
2021-06-14 20:00:33,5,4,2,6,3,BTC,3,2,2021,6,2
2021-06-15 08:18:37,19,28,0,42,3,BTC,39,28,2021,6,2
2021-06-15 18:27:49,3,7,0,5,0,BTC,5,7,2021,6,2
2021-06-16 18:43:49,6,0,2,4,1,BTC,3,-2,2021,6,2
2021-06-17 07:20:00,3,7,1,11,0,BTC,11,6,2021,6,2
2021-06-17 14:54:00,21,28,0,41,0,BTC,41,28,2021,6,2
2021-06-17 17:38:10,7,9,0,12,0,BTC,12,9,2021,6,2
2021-06-18 16:06:43,5,13,5,11,9,BTC,2,8,2021,6,2
2021-06-18 18:51:51,4,6,0,7,1,BTC,6,6,2021,6,2
2021-06-18 20:30:00,12,32,0,41,0,BTC,41,32,2021,6,2
2021-06-19 15:10:27,9,14,0,13,0,BTC,13,14,2021,6,2
2021-06-20 09:09:13,11,15,3,22,6,BTC,16,12,2021,6,2
2021-06-20 10:55:46,5,3,5,12,16,BTC,-4,-2,2021,6,2
2021-06-20 19:08:06,6,8,1,10,1,BTC,9,7,2021,6,2
2021-06-21 08:00:20,7,4,4,3,6,BTC,-3,0,2021,6,2
2021-06-22 10:56:27,13,21,1,32,1,BTC,31,20,2021,6,2
2021-06-22 16:14:23,11,26,4,28,2,BTC,26,22,2021,6,2
2021-06-22 17:42:44,5,7,0,19,2,BTC,17,7,2021,6,2
2021-06-22 23:50:48,20,33,3,43,2,BTC,41,30,2021,6,2
2021-06-23 00:20:00,4,11,4,6,7,BTC,-1,7,2021,6,2
2021-06-23 16:41:24,6,11,13,15,20,BTC,-5,-2,2021,6,2
2021-06-23 22:05:12,4,7,0,5,2,BTC,3,7,2021,6,2
2021-06-24 08:20:52,13,24,2,36,4,BTC,32,22,2021,6,2
2021-06-25 16:14:00,7,3,2,1,15,BTC,-14,1,2021,6,2
2021-06-25 17:50:26,5,7,4,6,6,BTC,0,3,2021,6,2
2021-06-26 09:30:00,4,6,0,9,0,BTC,9,6,2021,6,2
2021-06-26 11:45:50,3,4,1,8,4,BTC,4,3,2021,6,2
2021-06-26 12:20:10,11,6,2,4,19,BTC,-15,4,2021,6,2
2021-06-27 09:00:40,5,4,1,2,8,BTC,-6,3,2021,6,2
2021-06-27 20:13:03,4,6,0,5,3,BTC,2,6,2021,6,2
2021-06-28 06:07:00,7,9,34,13,24,BTC,-11,-25,2021,6,2
2021-06-28 15:10:23,3,3,1,4,2,BTC,2,2,2021,6,2
2021-06-28 19:00:53,3,7,0,7,2,BTC,5,7,2021,6,2
2021-06-28 20:50:00,4,6,0,6,2,BTC,4,6,2021,6,2
2021-06-29 03:08:17,4,4,0,7,4,BTC,3,4,2021,6,2
2021-06-29 05:03:38,5,7,7,8,11,BTC,-3,0,2021,6,2
2021-06-29 06:08:32,3,6,6,3,8,BTC,-5,0,2021,6,2
2021-06-29 13:43:00,9,19,1,27,3,BTC,24,18,2021,6,2
2021-06-29 15:10:13,6,11,58,15,47,BTC,-32,-47,2021,6,2
2021-06-30 03:08:44,4,4,1,1,6,BTC,-5,3,2021,6,2
2021-06-30 07:04:38,4,9,4,9,4,BTC,5,5,2021,6,2
2021-06-30 08:41:40,3,8,1,11,2,BTC,9,7,2021,6,2
2021-06-30 21:45:00,4,2,1,3,4,BTC,-1,1,2021,6,2
2021-07-01 07:04:42,3,4,2,5,2,BTC,3,2,2021,7,3
2021-07-01 09:10:00,7,17,20,21,21,BTC,0,-3,2021,7,3
2021-07-02 18:33:51,44,64,1,85,0,BTC,85,63,2021,7,3
2021-07-02 23:00:02,3,3,3,1,4,BTC,-3,0,2021,7,3
2021-07-03 08:45:03,3,4,4,2,7,BTC,-5,0,2021,7,3
2021-07-03 11:45:06,5,6,1,10,3,BTC,7,5,2021,7,3
2021-07-03 22:05:20,3,5,11,5,1,BTC,4,-6,2021,7,3
2021-07-03 22:17:34,4,9,9,7,3,BTC,4,0,2021,7,3
2021-07-04 08:22:00,13,41,2,27,2,BTC,25,39,2021,7,3
2021-07-05 22:18:01,15,19,1,26,0,BTC,26,18,2021,7,3
2021-07-06 19:08:43,5,5,2,5,1,BTC,4,3,2021,7,3
2021-07-07 13:41:08,5,8,1,9,3,BTC,6,7,2021,7,3
2021-07-07 22:32:19,4,6,7,5,4,BTC,1,-1,2021,7,3
2021-07-08 04:20:00,3,4,1,2,3,BTC,-1,3,2021,7,3
2021-07-08 09:53:42,5,4,1,3,7,BTC,-4,3,2021,7,3
2021-07-08 21:50:00,8,10,10,13,8,BTC,5,0,2021,7,3
2021-07-09 07:47:51,7,10,42,14,30,BTC,-16,-32,2021,7,3
2021-07-09 07:53:17,5,7,35,10,28,BTC,-18,-28,2021,7,3
2021-07-09 08:10:00,8,6,31,12,28,BTC,-16,-25,2021,7,3
2021-07-09 10:01:41,3,4,3,5,4,BTC,1,1,2021,7,3
2021-07-09 12:07:10,5,6,1,6,2,BTC,4,5,2021,7,3
2021-07-09 13:35:13,3,4,2,4,1,BTC,3,2,2021,7,3
2021-07-09 16:30:37,5,2,1,2,3,BTC,-1,1,2021,7,3
2021-07-10 00:23:00,3,3,5,4,5,BTC,-1,-2,2021,7,3
2021-07-10 07:01:28,11,9,11,5,21,BTC,-16,-2,2021,7,3
2021-07-10 12:12:15,3,7,21,9,23,BTC,-14,-14,2021,7,3
2021-07-11 06:23:10,18,33,3,44,6,BTC,38,30,2021,7,3
2021-07-12 13:17:24,4,7,0,11,0,BTC,11,7,2021,7,3
2021-07-16 13:00:09,7,13,0,16,1,BTC,15,13,2021,7,3
2021-07-17 17:38:23,4,7,7,10,5,BTC,5,0,2021,7,3
2021-07-18 22:43:46,3,6,0,3,0,BTC,3,6,2021,7,3
2021-07-20 03:40:06,4,9,4,8,1,BTC,7,5,2021,7,3
2021-07-20 09:03:15,5,1,6,3,13,BTC,-10,-5,2021,7,3
2021-07-20 09:33:54,6,7,3,3,4,BTC,-1,4,2021,7,3
2021-07-21 13:52:59,11,17,1,24,4,BTC,20,16,2021,7,3
2021-07-22 07:15:09,4,7,3,11,3,BTC,8,4,2021,7,3
2021-07-22 07:27:55,5,12,4,13,1,BTC,12,8,2021,7,3
2021-07-22 08:14:24,3,8,1,8,0,BTC,8,7,2021,7,3
2021-07-22 12:24:43,16,19,2,33,1,BTC,32,17,2021,7,3
2021-07-22 18:22:48,20,22,1,36,1,BTC,35,21,2021,7,3
2021-07-23 18:00:50,6,12,0,11,1,BTC,10,12,2021,7,3
2021-07-23 21:50:00,5,6,2,9,1,BTC,8,4,2021,7,3
2021-07-24 00:05:00,3,3,0,2,0,BTC,2,3,2021,7,3
2021-07-24 11:26:20,3,4,0,3,1,BTC,2,4,2021,7,3
2021-07-25 14:05:59,3,3,2,5,4,BTC,1,1,2021,7,3
2021-07-25 17:30:02,3,8,0,10,1,BTC,9,8,2021,7,3
2021-07-25 22:10:00,9,25,48,29,43,BTC,-14,-23,2021,7,3
2021-07-26 22:12:04,6,5,5,2,10,BTC,-8,0,2021,7,3
2021-07-27 08:41:33,5,1,4,0,6,BTC,-6,-3,2021,7,3
2021-07-27 21:50:00,9,16,1,24,2,BTC,22,15,2021,7,3
2021-07-28 03:08:34,18,25,1,31,3,BTC,28,24,2021,7,3
2021-07-28 11:28:57,3,9,1,10,0,BTC,10,8,2021,7,3
2021-07-28 18:00:08,23,31,5,43,7,BTC,36,26,2021,7,3
2021-07-29 18:35:17,3,3,0,8,0,BTC,8,3,2021,7,3
2021-07-30 10:41:00,4,10,2,3,6,BTC,-3,8,2021,7,3
2021-08-03 00:30:55,3,1,6,1,4,BTC,-3,-5,2021,8,3
2021-08-03 07:04:28,9,15,1,31,3,BTC,28,14,2021,8,3
2021-08-03 10:41:52,4,7,0,10,0,BTC,10,7,2021,8,3
2021-08-03 20:58:40,4,8,2,4,3,BTC,1,6,2021,8,3
2021-08-04 02:30:02,3,4,0,3,1,BTC,2,4,2021,8,3
2021-08-04 05:29:00,3,5,1,0,12,BTC,-12,4,2021,8,3
2021-08-05 09:00:17,5,4,1,9,1,BTC,8,3,2021,8,3
2021-08-05 09:33:27,3,0,2,3,3,BTC,0,-2,2021,8,3
2021-08-05 12:53:38,4,6,6,2,15,BTC,-13,0,2021,8,3
2021-08-05 22:27:00,15,18,0,24,0,BTC,24,18,2021,8,3
2021-08-06 08:19:58,14,22,0,25,1,BTC,24,22,2021,8,3
2021-08-06 20:09:28,6,9,1,14,2,BTC,12,8,2021,8,3
2021-08-07 02:20:00,18,22,1,42,1,BTC,41,21,2021,8,3
2021-08-07 07:04:49,20,30,2,41,15,BTC,26,28,2021,8,3
2021-08-08 09:10:00,12,21,0,31,1,BTC,30,21,2021,8,3
2021-08-12 00:20:00,3,10,2,12,1,BTC,11,8,2021,8,3
2021-08-12 08:10:47,3,6,6,7,4,BTC,3,0,2021,8,3
2021-08-14 00:09:18,3,4,1,8,7,BTC,1,3,2021,8,3
2021-08-14 13:00:47,4,6,1,9,0,BTC,9,5,2021,8,3
2021-08-15 00:00:38,3,6,0,10,0,BTC,10,6,2021,8,3
2021-08-15 07:42:42,3,7,0,8,0,BTC,8,7,2021,8,3
2021-08-15 11:45:08,4,4,30,6,24,BTC,-18,-26,2021,8,3
2021-08-15 11:51:46,14,18,63,23,69,BTC,-46,-45,2021,8,3
2021-08-16 14:36:29,3,6,12,9,11,BTC,-2,-6,2021,8,3
2021-08-16 17:00:04,4,7,2,9,1,BTC,8,5,2021,8,3
2021-08-17 03:42:00,12,19,1,30,2,BTC,28,18,2021,8,3
2021-08-17 06:15:29,6,2,5,5,12,BTC,-7,-3,2021,8,3
2021-08-19 00:15:10,4,1,2,6,9,BTC,-3,-1,2021,8,3
2021-08-19 08:46:57,27,41,0,47,2,BTC,45,41,2021,8,3
2021-08-19 10:46:20,13,8,21,6,19,BTC,-13,-13,2021,8,3
2021-08-19 11:32:37,3,0,2,0,4,BTC,-4,-2,2021,8,3
2021-08-19 18:42:55,20,38,9,59,12,BTC,47,29,2021,8,3
2021-08-20 17:00:05,14,27,3,35,3,BTC,32,24,2021,8,3
2021-08-20 18:58:26,3,3,3,5,7,BTC,-2,0,2021,8,3
2021-08-20 22:05:08,4,6,0,8,0,BTC,8,6,2021,8,3
2021-08-21 16:00:00,6,5,5,6,5,BTC,1,0,2021,8,3
2021-08-22 12:22:18,8,2,4,0,9,BTC,-9,-2,2021,8,3
2021-08-22 12:59:16,3,0,4,0,6,BTC,-6,-4,2021,8,3
2021-08-22 13:22:25,3,2,4,2,7,BTC,-5,-2,2021,8,3
2021-08-22 13:55:47,4,4,3,2,6,BTC,-4,1,2021,8,3
2021-08-22 19:14:09,3,8,2,9,2,BTC,7,6,2021,8,3
2021-08-23 07:18:38,13,19,0,31,0,BTC,31,19,2021,8,3
2021-08-23 14:00:03,3,6,2,7,1,BTC,6,4,2021,8,3
2021-08-23 15:45:49,3,5,2,6,2,BTC,4,3,2021,8,3
2021-08-23 17:00:58,5,21,3,30,4,BTC,26,18,2021,8,3
2021-08-23 17:33:45,3,2,2,7,5,BTC,2,0,2021,8,3
2021-08-23 19:55:11,18,25,0,35,0,BTC,35,25,2021,8,3
2021-08-23 23:00:26,7,11,0,15,0,BTC,15,11,2021,8,3
2021-08-23 23:45:01,46,70,3,82,4,BTC,78,67,2021,8,3
2021-08-24 07:47:42,9,19,1,19,1,BTC,18,18,2021,8,3
2021-08-24 09:44:48,7,9,3,7,13,BTC,-6,6,2021,8,3
2021-08-24 10:02:36,5,11,1,9,1,BTC,8,10,2021,8,3
2021-08-24 10:03:48,3,8,0,5,0,BTC,5,8,2021,8,3
2021-08-24 18:20:00,4,1,2,1,5,BTC,-4,-1,2021,8,3
2021-08-25 00:20:00,12,18,4,26,3,BTC,23,14,2021,8,3
2021-08-25 06:16:23,4,6,3,8,2,BTC,6,3,2021,8,3
2021-08-25 12:45:18,5,1,3,4,7,BTC,-3,-2,2021,8,3
2021-08-25 16:08:53,3,5,2,2,4,BTC,-2,3,2021,8,3
2021-08-25 16:23:09,10,12,1,21,3,BTC,18,11,2021,8,3
2021-08-26 07:17:20,6,5,16,17,17,BTC,0,-11,2021,8,3
2021-08-26 09:00:06,3,2,3,2,5,BTC,-3,-1,2021,8,3
2021-08-27 09:24:40,4,6,2,6,7,BTC,-1,4,2021,8,3
2021-08-27 10:59:45,8,26,4,27,8,BTC,19,22,2021,8,3
2021-08-28 07:44:10,5,7,3,8,10,BTC,-2,4,2021,8,3
2021-08-28 16:00:58,3,6,5,0,14,BTC,-14,1,2021,8,3
2021-08-28 22:37:08,6,10,1,13,1,BTC,12,9,2021,8,3
2021-08-29 09:00:59,25,42,4,49,5,BTC,44,38,2021,8,3
2021-08-29 12:53:41,3,5,3,7,8,BTC,-1,2,2021,8,3
2021-08-29 20:22:22,4,7,1,7,2,BTC,5,6,2021,8,3
2021-08-30 08:56:39,15,24,0,33,3,BTC,30,24,2021,8,3
2021-08-30 17:00:04,28,47,4,57,5,BTC,52,43,2021,8,3
2021-08-30 19:00:50,15,26,4,37,5,BTC,32,22,2021,8,3
2021-08-31 08:28:48,6,5,0,7,0,BTC,7,5,2021,8,3
2021-08-31 15:39:04,3,3,0,4,0,BTC,4,3,2021,8,3
2021-08-31 19:00:25,16,27,1,38,1,BTC,37,26,2021,8,3
2021-09-01 08:46:17,3,9,0,10,0,BTC,10,9,2021,9,3
2021-09-01 13:07:00,3,4,2,3,4,BTC,-1,2,2021,9,3
2021-09-01 17:30:39,26,46,2,53,2,BTC,51,44,2021,9,3
2021-09-03 08:52:00,8,16,1,23,1,BTC,22,15,2021,9,3
2021-09-03 19:00:49,4,6,0,7,3,BTC,4,6,2021,9,3
2021-09-04 01:37:09,3,7,1,10,1,BTC,9,6,2021,9,3
2021-09-04 09:24:51,21,38,0,43,0,BTC,43,38,2021,9,3
2021-09-05 08:03:39,5,15,1,15,3,BTC,12,14,2021,9,3
2021-09-05 11:25:02,5,22,1,26,1,BTC,25,21,2021,9,3
2021-09-05 16:55:30,3,6,0,8,1,BTC,7,6,2021,9,3
2021-09-06 10:08:57,11,19,2,24,3,BTC,21,17,2021,9,3
2021-09-06 13:09:19,3,3,9,2,8,BTC,-6,-6,2021,9,3
2021-09-06 18:00:21,19,22,3,27,5,BTC,22,19,2021,9,3
2021-09-06 21:08:22,8,5,7,4,7,BTC,-3,-2,2021,9,3
2021-09-07 03:00:09,5,9,0,13,0,BTC,13,9,2021,9,3
2021-09-07 11:53:12,3,2,1,4,4,BTC,0,1,2021,9,3
2021-09-07 13:24:59,3,1,1,1,3,BTC,-2,0,2021,9,3
2021-09-07 13:25:00,3,4,3,4,4,BTC,0,1,2021,9,3
2021-09-07 14:30:43,5,13,3,6,18,BTC,-12,10,2021,9,3
2021-09-07 16:00:00,4,1,1,1,4,BTC,-3,0,2021,9,3
2021-09-07 16:36:32,3,1,2,2,6,BTC,-4,-1,2021,9,3
2021-09-08 04:07:48,3,1,1,0,6,BTC,-6,0,2021,9,3
2021-09-08 05:54:03,5,14,1,18,1,BTC,17,13,2021,9,3
2021-09-08 09:30:33,3,0,3,1,3,BTC,-2,-3,2021,9,3
2021-09-08 18:41:40,4,6,0,6,0,BTC,6,6,2021,9,3
2021-09-09 08:00:00,4,2,0,1,0,BTC,1,2,2021,9,3
2021-09-09 16:00:04,7,8,2,16,1,BTC,15,6,2021,9,3
2021-09-10 10:00:35,3,0,1,2,3,BTC,-1,-1,2021,9,3
2021-09-10 11:00:30,12,6,10,7,22,BTC,-15,-4,2021,9,3
2021-09-11 07:04:07,7,15,1,20,2,BTC,18,14,2021,9,3
2021-09-11 11:30:51,3,3,0,4,0,BTC,4,3,2021,9,3
2021-09-11 13:30:01,3,3,0,7,2,BTC,5,3,2021,9,3
2021-09-12 07:41:16,3,5,0,8,1,BTC,7,5,2021,9,3
2021-09-12 13:15:29,3,7,1,6,2,BTC,4,6,2021,9,3
2021-09-12 20:12:53,8,3,14,7,20,BTC,-13,-11,2021,9,3
2021-09-12 20:35:31,3,6,1,10,1,BTC,9,5,2021,9,3
2021-09-13 08:00:19,20,27,3,38,4,BTC,34,24,2021,9,3
2021-09-13 09:03:25,15,9,3,5,12,BTC,-7,6,2021,9,3
2021-09-14 17:19:01,3,0,2,1,4,BTC,-3,-2,2021,9,3
2021-09-14 17:41:00,6,1,2,0,3,BTC,-3,-1,2021,9,3
2021-09-14 20:00:17,10,19,3,19,1,BTC,18,16,2021,9,3
2021-09-15 03:08:00,4,10,0,9,0,BTC,9,10,2021,9,3
2021-09-15 15:35:37,3,0,2,0,5,BTC,-5,-2,2021,9,3
2021-09-15 15:53:58,3,4,1,8,1,BTC,7,3,2021,9,3
2021-09-16 07:09:06,4,7,1,8,1,BTC,7,6,2021,9,3
2021-09-16 08:35:38,4,4,13,4,10,BTC,-6,-9,2021,9,3
2021-09-16 12:48:08,9,10,1,12,1,BTC,11,9,2021,9,3
2021-09-16 17:44:57,4,1,20,0,19,BTC,-19,-19,2021,9,3
2021-09-17 08:55:30,3,1,0,5,5,BTC,0,1,2021,9,3
2021-09-17 09:24:48,7,7,1,15,1,BTC,14,6,2021,9,3
2021-09-19 09:58:46,10,5,9,5,16,BTC,-11,-4,2021,9,3
2021-09-19 12:00:47,4,3,2,4,12,BTC,-8,1,2021,9,3
2021-09-19 22:05:40,6,9,4,4,15,BTC,-11,5,2021,9,3
2021-09-20 03:08:33,20,13,12,9,41,BTC,-32,1,2021,9,3
2021-09-20 07:57:29,3,0,1,1,9,BTC,-8,-1,2021,9,3
2021-09-20 09:30:21,8,0,2,0,9,BTC,-9,-2,2021,9,3
2021-09-20 11:46:39,6,4,5,2,24,BTC,-22,-1,2021,9,3
2021-09-20 12:02:21,5,4,0,1,7,BTC,-6,4,2021,9,3
2021-09-20 13:42:00,4,1,7,2,11,BTC,-9,-6,2021,9,3
2021-09-20 14:13:14,11,16,2,21,2,BTC,19,14,2021,9,3
2021-09-20 18:30:07,4,14,1,14,1,BTC,13,13,2021,9,3
2021-09-21 03:08:32,4,5,0,4,6,BTC,-2,5,2021,9,3
2021-09-21 05:31:40,6,16,1,21,2,BTC,19,15,2021,9,3
2021-09-21 10:18:56,4,2,8,4,6,BTC,-2,-6,2021,9,3
2021-09-21 10:55:23,6,1,3,3,10,BTC,-7,-2,2021,9,3
2021-09-21 13:13:01,4,14,1,20,1,BTC,19,13,2021,9,3
2021-09-21 16:05:09,6,11,6,6,21,BTC,-15,5,2021,9,3
2021-09-21 20:00:53,3,0,5,0,3,BTC,-3,-5,2021,9,3
2021-09-22 02:25:00,8,9,1,7,9,BTC,-2,8,2021,9,3
2021-09-22 03:00:00,6,6,2,3,9,BTC,-6,4,2021,9,3
2021-09-22 13:03:04,53,6,15,7,16,BTC,-9,-9,2021,9,3
2021-09-22 17:09:41,16,32,8,38,5,BTC,33,24,2021,9,3
2021-09-22 23:00:05,5,8,0,5,0,BTC,5,8,2021,9,3
2021-09-23 13:25:17,10,14,5,17,22,BTC,-5,9,2021,9,3
2021-09-23 19:43:38,10,18,1,29,3,BTC,26,17,2021,9,3
2021-09-23 23:45:04,4,3,0,3,1,BTC,2,3,2021,9,3
2021-09-24 09:22:14,48,18,43,34,68,BTC,-34,-25,2021,9,3
2021-09-24 09:46:00,11,6,17,17,28,BTC,-11,-11,2021,9,3
2021-09-24 11:01:56,6,5,4,6,8,BTC,-2,1,2021,9,3
2021-09-24 12:04:55,3,1,5,5,6,BTC,-1,-4,2021,9,3
2021-09-24 12:15:25,3,5,8,8,15,BTC,-7,-3,2021,9,3
2021-09-24 12:31:00,3,3,13,5,9,BTC,-4,-10,2021,9,3
2021-09-24 14:27:32,3,1,4,0,7,BTC,-7,-3,2021,9,3
2021-09-24 17:00:07,12,20,1,30,2,BTC,28,19,2021,9,3
2021-09-25 10:17:36,4,5,4,5,10,BTC,-5,1,2021,9,3
2021-09-25 11:23:48,10,3,7,6,12,BTC,-6,-4,2021,9,3
2021-09-26 12:30:57,3,4,1,9,0,BTC,9,3,2021,9,3
2021-09-26 13:36:50,28,40,1,50,1,BTC,49,39,2021,9,3
2021-09-26 17:00:53,7,3,3,2,3,BTC,-1,0,2021,9,3
2021-09-26 18:45:13,5,7,5,5,5,BTC,0,2,2021,9,3
2021-09-27 03:08:21,10,24,2,27,3,BTC,24,22,2021,9,3
2021-09-27 12:28:30,4,3,1,6,0,BTC,6,2,2021,9,3
2021-09-27 18:50:18,11,13,19,19,28,BTC,-9,-6,2021,9,3
2021-09-28 07:33:12,6,5,1,4,9,BTC,-5,4,2021,9,3
2021-09-28 07:54:23,3,0,1,0,3,BTC,-3,-1,2021,9,3
2021-09-28 08:49:18,6,3,7,2,14,BTC,-12,-4,2021,9,3
2021-09-28 13:25:00,3,4,2,4,5,BTC,-1,2,2021,9,3
2021-09-28 18:25:14,11,7,5,7,10,BTC,-3,2,2021,9,3
2021-09-28 19:00:58,24,18,16,24,27,BTC,-3,2,2021,9,3
2021-09-29 15:20:44,3,5,15,8,8,BTC,0,-10,2021,9,3
2021-09-29 17:01:00,8,17,3,20,3,BTC,17,14,2021,9,3
2021-09-29 19:14:02,12,3,29,5,21,BTC,-16,-26,2021,9,3
2021-09-30 13:26:52,4,5,1,6,1,BTC,5,4,2021,9,3
2021-10-01 06:20:00,9,20,1,30,3,BTC,27,19,2021,10,4
2021-10-01 11:30:02,13,24,1,27,1,BTC,26,23,2021,10,4
2021-10-01 11:48:00,4,8,1,6,1,BTC,5,7,2021,10,4
2021-10-01 13:30:18,9,14,2,17,2,BTC,15,12,2021,10,4
2021-10-01 15:42:50,25,6,21,7,43,BTC,-36,-15,2021,10,4
2021-10-01 23:00:20,8,15,6,11,4,BTC,7,9,2021,10,4
2021-10-03 01:30:11,4,4,6,3,9,BTC,-6,-2,2021,10,4
2021-10-03 10:11:17,3,5,0,6,0,BTC,6,5,2021,10,4
2021-10-03 14:45:50,6,4,4,7,9,BTC,-2,0,2021,10,4
2021-10-03 20:00:57,4,7,3,4,7,BTC,-3,4,2021,10,4
2021-10-03 21:01:24,5,5,16,11,16,BTC,-5,-11,2021,10,4
2021-10-04 18:00:00,20,42,1,57,0,BTC,57,41,2021,10,4
2021-10-05 08:21:00,3,5,3,5,4,BTC,1,2,2021,10,4
2021-10-05 14:19:38,14,16,0,22,1,BTC,21,16,2021,10,4
2021-10-06 08:06:00,12,4,21,12,35,BTC,-23,-17,2021,10,4
2021-10-06 20:39:39,8,5,21,15,19,BTC,-4,-16,2021,10,4
2021-10-07 00:47:01,3,5,0,7,0,BTC,7,5,2021,10,4
2021-10-07 09:09:50,15,12,17,13,29,BTC,-16,-5,2021,10,4
2021-10-07 12:38:49,8,8,12,10,20,BTC,-10,-4,2021,10,4
2021-10-07 19:19:55,10,14,1,23,1,BTC,22,13,2021,10,4
2021-10-07 23:00:32,15,34,3,29,3,BTC,26,31,2021,10,4
2021-10-08 18:22:08,4,3,7,3,3,BTC,0,-4,2021,10,4
2021-10-08 21:35:00,3,3,0,3,0,BTC,3,3,2021,10,4
2021-10-08 23:11:28,3,1,4,0,3,BTC,-3,-3,2021,10,4
2021-10-09 08:20:13,6,7,7,8,7,BTC,1,0,2021,10,4
2021-10-10 10:15:59,19,31,7,44,7,BTC,37,24,2021,10,4
2021-10-10 11:00:38,19,27,0,43,1,BTC,42,27,2021,10,4
2021-10-11 18:00:49,21,47,1,63,1,BTC,62,46,2021,10,4
2021-10-12 04:20:30,5,4,0,5,0,BTC,5,4,2021,10,4
2021-10-12 08:58:03,24,33,0,38,0,BTC,38,33,2021,10,4
2021-10-12 09:42:37,3,4,2,6,2,BTC,4,2,2021,10,4
2021-10-12 12:31:00,6,18,6,29,8,BTC,21,12,2021,10,4
2021-10-12 16:00:15,3,6,0,10,0,BTC,10,6,2021,10,4
2021-10-12 18:59:40,3,3,0,5,0,BTC,5,3,2021,10,4
2021-10-12 20:00:21,8,9,0,13,0,BTC,13,9,2021,10,4
2021-10-13 02:33:28,7,6,2,11,19,BTC,-8,4,2021,10,4
2021-10-13 12:00:00,4,5,7,6,13,BTC,-7,-2,2021,10,4
2021-10-13 17:30:00,6,7,1,8,1,BTC,7,6,2021,10,4
2021-10-13 18:41:20,6,9,0,12,0,BTC,12,9,2021,10,4
2021-10-14 06:15:12,9,21,7,32,6,BTC,26,14,2021,10,4
2021-10-14 09:31:55,4,4,4,2,16,BTC,-14,0,2021,10,4
2021-10-14 13:27:27,13,27,0,38,1,BTC,37,27,2021,10,4
2021-10-14 14:18:08,3,8,0,9,0,BTC,9,8,2021,10,4
2021-10-15 11:30:13,3,2,1,1,4,BTC,-3,1,2021,10,4
2021-10-16 22:31:51,4,3,1,4,3,BTC,1,2,2021,10,4
2021-10-17 09:46:07,6,16,20,27,16,BTC,11,-4,2021,10,4
2021-10-17 21:30:00,12,27,1,39,0,BTC,39,26,2021,10,4
2021-10-17 23:30:23,8,4,1,1,5,BTC,-4,3,2021,10,4
2021-10-18 03:08:40,8,17,0,22,1,BTC,21,17,2021,10,4
2021-10-18 07:15:43,3,4,10,5,8,BTC,-3,-6,2021,10,4
2021-10-18 22:05:52,3,2,0,2,0,BTC,2,2,2021,10,4
2021-10-18 22:11:21,4,6,0,9,0,BTC,9,6,2021,10,4
2021-10-19 10:56:01,4,5,7,6,4,BTC,2,-2,2021,10,4
2021-10-19 17:02:50,3,4,9,4,17,BTC,-13,-5,2021,10,4
2021-10-20 12:54:14,5,5,0,6,0,BTC,6,5,2021,10,4
2021-10-20 22:45:39,19,24,17,33,18,BTC,15,7,2021,10,4
2021-10-21 12:00:00,5,0,5,0,9,BTC,-9,-5,2021,10,4
2021-10-21 12:30:01,5,0,4,1,7,BTC,-6,-4,2021,10,4
2021-10-21 12:52:52,5,1,5,2,8,BTC,-6,-4,2021,10,4
2021-10-21 15:09:49,4,1,4,8,13,BTC,-5,-3,2021,10,4
2021-10-21 22:05:13,3,5,0,7,1,BTC,6,5,2021,10,4
2021-10-21 23:15:23,10,11,15,12,13,BTC,-1,-4,2021,10,4
2021-10-22 10:37:22,16,28,0,34,0,BTC,34,28,2021,10,4
2021-10-22 15:46:23,19,43,0,51,0,BTC,51,43,2021,10,4
2021-10-22 17:23:01,12,2,2,3,7,BTC,-4,0,2021,10,4
2021-10-23 17:00:46,3,7,0,9,0,BTC,9,7,2021,10,4
2021-10-23 23:00:23,20,35,4,37,9,BTC,28,31,2021,10,4
2021-10-25 09:44:00,6,3,0,6,1,BTC,5,3,2021,10,4
2021-10-26 00:54:41,8,20,6,27,3,BTC,24,14,2021,10,4
2021-10-26 17:52:42,3,6,0,8,0,BTC,8,6,2021,10,4
2021-10-27 08:05:46,11,22,8,13,23,BTC,-10,14,2021,10,4
2021-10-27 08:28:51,3,1,0,4,6,BTC,-2,1,2021,10,4
2021-10-27 09:09:39,5,1,3,0,6,BTC,-6,-2,2021,10,4
2021-10-27 12:26:00,16,32,6,37,6,BTC,31,26,2021,10,4
2021-10-27 13:04:38,12,16,7,19,5,BTC,14,9,2021,10,4
2021-10-27 16:08:56,7,19,4,22,7,BTC,15,15,2021,10,4
2021-10-27 21:36:26,3,5,0,6,0,BTC,6,5,2021,10,4
2021-10-27 22:38:43,6,13,3,12,2,BTC,10,10,2021,10,4
2021-10-28 02:20:00,8,18,2,21,2,BTC,19,16,2021,10,4
2021-10-28 05:24:43,4,2,4,1,6,BTC,-5,-2,2021,10,4
2021-10-28 09:26:26,8,24,22,27,20,BTC,7,2,2021,10,4
2021-10-28 09:48:06,13,20,0,28,0,BTC,28,20,2021,10,4
2021-10-28 10:55:58,5,11,6,12,4,BTC,8,5,2021,10,4
2021-10-28 11:45:06,10,15,0,17,0,BTC,17,15,2021,10,4
2021-10-28 12:24:46,13,23,7,31,27,BTC,4,16,2021,10,4
2021-10-28 18:47:15,5,5,1,2,6,BTC,-4,4,2021,10,4
2021-10-28 20:30:00,5,4,14,4,12,BTC,-8,-10,2021,10,4
2021-10-29 10:37:45,5,4,3,6,1,BTC,5,1,2021,10,4
2021-10-29 22:27:53,8,12,13,20,6,BTC,14,-1,2021,10,4
2021-10-30 14:40:46,4,22,9,24,13,BTC,11,13,2021,10,4
2021-10-31 14:34:51,4,1,0,3,5,BTC,-2,1,2021,10,4
2021-10-31 20:17:33,5,10,0,9,0,BTC,9,10,2021,10,4
2021-10-31 20:37:15,12,16,12,29,13,BTC,16,4,2021,10,4
2021-11-01 09:50:03,3,6,1,8,1,BTC,7,5,2021,11,4
2021-11-01 13:30:36,6,11,0,17,1,BTC,16,11,2021,11,4
2021-11-02 09:53:10,6,7,0,7,0,BTC,7,7,2021,11,4
2021-11-02 22:05:37,16,32,0,38,0,BTC,38,32,2021,11,4
2021-11-03 06:58:43,5,5,1,5,1,BTC,4,4,2021,11,4
2021-11-03 13:24:12,3,2,1,1,5,BTC,-4,1,2021,11,4
2021-11-04 09:15:38,15,28,1,43,4,BTC,39,27,2021,11,4
2021-11-04 17:10:07,15,23,2,32,1,BTC,31,21,2021,11,4
2021-11-05 07:04:17,4,5,0,5,0,BTC,5,5,2021,11,4
2021-11-05 09:50:12,3,2,1,3,1,BTC,2,1,2021,11,4
2021-11-05 23:00:33,4,2,8,5,3,BTC,2,-6,2021,11,4
2021-11-06 09:17:04,4,10,2,10,2,BTC,8,8,2021,11,4
2021-11-06 10:45:47,9,14,0,19,0,BTC,19,14,2021,11,4
2021-11-06 11:39:59,5,4,13,2,6,BTC,-4,-9,2021,11,4
2021-11-07 07:04:15,8,9,2,14,0,BTC,14,7,2021,11,4
2021-11-07 09:19:58,11,22,0,22,0,BTC,22,22,2021,11,4
2021-11-08 09:51:48,3,4,0,6,0,BTC,6,4,2021,11,4
2021-11-08 13:00:02,3,14,1,6,3,BTC,3,13,2021,11,4
2021-11-09 03:20:00,8,11,1,12,3,BTC,9,10,2021,11,4
2021-11-09 09:28:33,4,6,0,7,0,BTC,7,6,2021,11,4
2021-11-09 13:00:52,4,5,1,6,0,BTC,6,4,2021,11,4
2021-11-09 16:00:53,3,5,6,6,3,BTC,3,-1,2021,11,4
2021-11-09 17:23:45,4,1,6,2,8,BTC,-6,-5,2021,11,4
2021-11-09 17:32:20,3,5,0,9,0,BTC,9,5,2021,11,4
2021-11-09 18:58:40,12,12,3,21,3,BTC,18,9,2021,11,4
2021-11-09 23:00:19,4,11,2,9,3,BTC,6,9,2021,11,4
2021-11-10 02:10:00,9,29,11,29,19,BTC,10,18,2021,11,4
2021-11-10 20:04:52,4,7,1,11,10,BTC,1,6,2021,11,4
2021-11-11 07:34:00,22,37,2,44,2,BTC,42,35,2021,11,4
2021-11-11 09:39:17,3,0,4,0,6,BTC,-6,-4,2021,11,4
2021-11-11 10:15:48,3,2,0,7,0,BTC,7,2,2021,11,4
2021-11-11 11:26:21,7,12,1,12,1,BTC,11,11,2021,11,4
2021-11-11 11:40:35,11,7,50,19,35,BTC,-16,-43,2021,11,4
2021-11-11 13:56:46,3,3,0,3,3,BTC,0,3,2021,11,4
2021-11-11 14:10:00,9,18,7,18,6,BTC,12,11,2021,11,4
2021-11-11 20:00:00,3,3,2,2,3,BTC,-1,1,2021,11,4
2021-11-12 03:20:00,9,16,23,20,27,BTC,-7,-7,2021,11,4
2021-11-12 09:53:21,3,2,2,5,5,BTC,0,0,2021,11,4
2021-11-12 16:22:36,3,4,0,5,0,BTC,5,4,2021,11,4
2021-11-12 16:44:30,8,5,2,3,18,BTC,-15,3,2021,11,4
2021-11-12 16:48:12,33,15,17,23,54,BTC,-31,-2,2021,11,4
2021-11-12 16:58:22,3,4,1,2,5,BTC,-3,3,2021,11,4
2021-11-12 17:00:07,19,42,4,54,4,BTC,50,38,2021,11,4
2021-11-12 17:15:55,3,1,1,0,5,BTC,-5,0,2021,11,4
2021-11-12 17:19:36,7,3,4,14,13,BTC,1,-1,2021,11,4
2021-11-12 17:26:17,11,7,8,2,13,BTC,-11,-1,2021,11,4
2021-11-12 18:56:22,11,28,18,27,12,BTC,15,10,2021,11,4
2021-11-12 23:01:47,3,7,0,5,1,BTC,4,7,2021,11,4
2021-11-13 23:05:46,4,10,0,13,0,BTC,13,10,2021,11,4
2021-11-14 14:09:03,3,3,2,6,0,BTC,6,1,2021,11,4
2021-11-14 16:07:21,11,28,1,31,1,BTC,30,27,2021,11,4
2021-11-14 20:01:53,3,10,0,8,0,BTC,8,10,2021,11,4
2021-11-14 23:05:58,3,10,2,6,2,BTC,4,8,2021,11,4
2021-11-15 02:08:00,3,2,1,0,5,BTC,-5,1,2021,11,4
2021-11-15 09:44:30,9,15,0,19,0,BTC,19,15,2021,11,4
2021-11-15 10:15:41,14,28,0,42,0,BTC,42,28,2021,11,4
2021-11-15 13:46:12,10,14,3,16,0,BTC,16,11,2021,11,4
2021-11-15 20:30:41,3,9,0,11,0,BTC,11,9,2021,11,4
2021-11-15 23:05:53,4,5,0,6,0,BTC,6,5,2021,11,4
2021-11-16 12:16:00,13,3,56,16,35,BTC,-19,-53,2021,11,4
2021-11-16 19:32:33,3,5,2,4,1,BTC,3,3,2021,11,4
2021-11-17 13:31:36,4,12,4,10,1,BTC,9,8,2021,11,4
2021-11-17 15:08:55,4,4,0,7,0,BTC,7,4,2021,11,4
2021-11-17 20:30:27,11,21,1,22,3,BTC,19,20,2021,11,4
2021-11-17 21:40:00,3,3,1,0,3,BTC,-3,2,2021,11,4
2021-11-18 14:52:00,7,13,2,14,3,BTC,11,11,2021,11,4
2021-11-18 20:50:00,4,6,1,9,2,BTC,7,5,2021,11,4
2021-11-19 16:11:14,9,21,7,16,3,BTC,13,14,2021,11,4
2021-11-19 19:05:24,3,5,0,5,0,BTC,5,5,2021,11,4
2021-11-19 21:15:00,3,0,5,0,6,BTC,-6,-5,2021,11,4
2021-11-20 02:30:00,17,18,1,26,1,BTC,25,17,2021,11,4
2021-11-20 09:54:17,3,4,0,3,0,BTC,3,4,2021,11,4
2021-11-20 19:45:20,3,2,4,1,5,BTC,-4,-2,2021,11,4
2021-11-21 08:04:02,8,12,1,14,0,BTC,14,11,2021,11,4
2021-11-21 09:00:06,12,18,0,27,1,BTC,26,18,2021,11,4
2021-11-21 20:20:04,24,27,17,29,25,BTC,4,10,2021,11,4
2021-11-21 21:25:42,14,38,1,36,3,BTC,33,37,2021,11,4
2021-11-21 23:24:04,3,6,2,5,1,BTC,4,4,2021,11,4
2021-11-22 10:18:28,8,8,0,9,1,BTC,8,8,2021,11,4
2021-11-22 10:55:57,5,5,7,5,6,BTC,-1,-2,2021,11,4
2021-11-22 14:36:19,4,4,0,4,0,BTC,4,4,2021,11,4
2021-11-22 14:53:51,6,10,2,9,2,BTC,7,8,2021,11,4
2021-11-22 22:44:06,3,4,0,4,0,BTC,4,4,2021,11,4
2021-11-24 05:08:57,4,3,0,3,0,BTC,3,3,2021,11,4
2021-11-24 19:05:54,3,6,1,5,0,BTC,5,5,2021,11,4
2021-11-25 14:30:00,3,4,0,5,0,BTC,5,4,2021,11,4
2021-11-25 20:29:08,15,10,8,1,14,BTC,-13,2,2021,11,4
2021-11-25 21:30:03,4,14,1,13,3,BTC,10,13,2021,11,4
2021-11-26 09:45:06,4,2,2,4,4,BTC,0,0,2021,11,4
2021-11-26 09:47:08,20,15,9,9,35,BTC,-26,6,2021,11,4
2021-11-26 13:53:25,3,5,4,5,2,BTC,3,1,2021,11,4
2021-11-26 19:49:54,3,4,0,4,0,BTC,4,4,2021,11,4
2021-11-26 20:21:58,8,2,3,0,8,BTC,-8,-1,2021,11,4
2021-11-26 23:00:15,11,34,1,35,1,BTC,34,33,2021,11,4
2021-11-27 10:45:03,4,7,1,4,1,BTC,3,6,2021,11,4
2021-11-29 08:04:47,3,4,0,8,1,BTC,7,4,2021,11,4
2021-11-29 11:30:18,4,6,3,8,5,BTC,3,3,2021,11,4
2021-11-30 09:42:22,6,12,3,12,7,BTC,5,9,2021,11,4
2021-11-30 10:30:10,3,7,1,8,3,BTC,5,6,2021,11,4
2021-11-30 11:03:49,3,8,0,7,1,BTC,6,8,2021,11,4
2021-11-30 12:54:26,5,7,1,7,1,BTC,6,6,2021,11,4
2021-11-30 13:12:25,25,45,4,59,5,BTC,54,41,2021,11,4
2021-11-30 16:26:20,3,18,2,20,2,BTC,18,16,2021,11,4
2021-11-30 18:25:16,4,12,0,10,1,BTC,9,12,2021,11,4
2021-11-30 19:00:05,14,24,2,30,3,BTC,27,22,2021,11,4
2021-11-30 20:30:20,4,7,0,6,1,BTC,5,7,2021,11,4
2021-11-30 20:30:31,4,6,1,8,1,BTC,7,5,2021,11,4
2021-12-01 11:14:08,8,10,2,15,1,BTC,14,8,2021,12,4
2021-12-01 15:13:01,8,19,2,20,3,BTC,17,17,2021,12,4
2021-12-02 07:11:53,16,6,6,3,16,BTC,-13,0,2021,12,4
2021-12-02 08:04:39,10,20,1,26,1,BTC,25,19,2021,12,4
2021-12-02 09:52:09,17,19,5,20,30,BTC,-10,14,2021,12,4
2021-12-02 10:41:58,6,0,2,0,4,BTC,-4,-2,2021,12,4
2021-12-02 11:11:41,4,1,1,0,4,BTC,-4,0,2021,12,4
2021-12-02 14:05:44,4,1,2,2,8,BTC,-6,-1,2021,12,4
2021-12-02 17:00:44,7,21,6,30,9,BTC,21,15,2021,12,4
2021-12-02 19:05:28,4,6,1,6,2,BTC,4,5,2021,12,4
2021-12-03 00:00:16,4,5,0,3,0,BTC,3,5,2021,12,4
2021-12-03 09:50:09,3,10,0,10,1,BTC,9,10,2021,12,4
2021-12-03 11:00:00,4,3,1,0,10,BTC,-10,2,2021,12,4
2021-12-03 15:03:23,4,2,0,4,0,BTC,4,2,2021,12,4
2021-12-03 15:52:55,4,19,1,19,1,BTC,18,18,2021,12,4
2021-12-03 19:05:51,16,32,1,42,2,BTC,40,31,2021,12,4
2021-12-03 21:45:04,4,3,13,3,20,BTC,-17,-10,2021,12,4
2021-12-03 22:42:26,17,14,5,18,17,BTC,1,9,2021,12,4
2021-12-04 06:56:03,34,76,0,68,1,BTC,67,76,2021,12,4
2021-12-04 08:04:19,8,10,3,25,7,BTC,18,7,2021,12,4
2021-12-04 09:34:46,6,8,3,13,10,BTC,3,5,2021,12,4
2021-12-04 12:29:56,11,15,2,11,15,BTC,-4,13,2021,12,4
2021-12-04 12:30:05,12,15,3,23,7,BTC,16,12,2021,12,4
2021-12-04 12:57:58,13,21,0,17,0,BTC,17,21,2021,12,4
2021-12-04 15:36:28,11,17,0,29,2,BTC,27,17,2021,12,4
2021-12-04 16:28:59,3,7,0,9,1,BTC,8,7,2021,12,4
2021-12-04 17:55:11,6,6,2,3,3,BTC,0,4,2021,12,4
2021-12-04 18:00:04,20,6,36,18,24,BTC,-6,-30,2021,12,4
2021-12-04 21:00:08,3,6,0,6,1,BTC,5,6,2021,12,4
2021-12-04 23:05:04,3,5,0,10,4,BTC,6,5,2021,12,4
2021-12-05 04:36:22,3,0,5,2,7,BTC,-5,-5,2021,12,4
2021-12-05 08:04:39,6,1,4,1,9,BTC,-8,-3,2021,12,4
2021-12-05 08:19:20,8,11,0,27,4,BTC,23,11,2021,12,4
2021-12-05 10:15:48,9,10,1,19,0,BTC,19,9,2021,12,4
2021-12-05 10:38:55,10,20,0,35,0,BTC,35,20,2021,12,4
2021-12-05 11:01:27,13,27,3,42,5,BTC,37,24,2021,12,4
2021-12-05 11:50:37,7,6,10,3,9,BTC,-6,-4,2021,12,4
2021-12-05 12:16:14,10,27,0,31,4,BTC,27,27,2021,12,4
2021-12-05 12:39:00,15,11,11,13,24,BTC,-11,0,2021,12,4
2021-12-05 15:00:58,3,1,4,2,7,BTC,-5,-3,2021,12,4
2021-12-05 15:30:34,4,4,1,5,2,BTC,3,3,2021,12,4
2021-12-05 16:15:02,4,1,1,2,7,BTC,-5,0,2021,12,4
2021-12-05 17:50:00,6,7,3,4,16,BTC,-12,4,2021,12,4
2021-12-05 22:37:52,3,9,0,7,0,BTC,7,9,2021,12,4
2021-12-06 01:56:43,10,24,1,31,1,BTC,30,23,2021,12,4
2021-12-06 09:16:39,6,10,1,13,3,BTC,10,9,2021,12,4
2021-12-06 10:30:32,3,7,0,8,0,BTC,8,7,2021,12,4
2021-12-06 12:00:51,13,8,5,17,15,BTC,2,3,2021,12,4
2021-12-06 13:30:49,6,5,8,11,9,BTC,2,-3,2021,12,4
2021-12-06 14:46:22,4,20,1,25,1,BTC,24,19,2021,12,4
2021-12-06 19:15:42,3,7,0,7,0,BTC,7,7,2021,12,4
2021-12-07 10:51:55,6,11,3,13,5,BTC,8,8,2021,12,4
2021-12-07 11:34:05,6,10,19,10,14,BTC,-4,-9,2021,12,4
2021-12-07 12:45:04,18,17,0,18,1,BTC,17,17,2021,12,4
2021-12-07 15:33:25,4,5,0,4,0,BTC,4,5,2021,12,4
2021-12-07 16:00:00,15,38,3,50,4,BTC,46,35,2021,12,4
2021-12-07 17:17:13,6,13,0,14,0,BTC,14,13,2021,12,4
2021-12-07 20:16:18,11,5,9,0,27,BTC,-27,-4,2021,12,4
2021-12-08 05:35:41,6,3,2,3,9,BTC,-6,1,2021,12,4
2021-12-08 08:04:11,7,19,2,26,0,BTC,26,17,2021,12,4
2021-12-08 12:48:43,7,6,10,11,9,BTC,2,-4,2021,12,4
2021-12-09 03:08:29,3,10,0,14,0,BTC,14,10,2021,12,4
2021-12-09 10:07:46,7,3,0,2,13,BTC,-11,3,2021,12,4
2021-12-09 15:08:38,4,5,1,5,3,BTC,2,4,2021,12,4
2021-12-09 19:00:12,9,5,15,9,27,BTC,-18,-10,2021,12,4
2021-12-09 23:05:50,4,7,0,9,0,BTC,9,7,2021,12,4
2021-12-10 09:46:22,8,3,3,6,11,BTC,-5,0,2021,12,4
2021-12-10 10:01:44,14,14,10,14,24,BTC,-10,4,2021,12,4
2021-12-10 14:16:16,3,1,2,0,5,BTC,-5,-1,2021,12,4
2021-12-10 14:23:40,6,15,2,25,3,BTC,22,13,2021,12,4
2021-12-10 14:48:40,8,7,2,13,18,BTC,-5,5,2021,12,4
2021-12-10 15:47:14,10,4,3,1,8,BTC,-7,1,2021,12,4
2021-12-10 16:17:16,4,1,2,5,16,BTC,-11,-1,2021,12,4
2021-12-10 17:15:00,5,2,1,3,6,BTC,-3,1,2021,12,4
2021-12-11 11:45:46,4,15,2,21,3,BTC,18,13,2021,12,4
2021-12-12 05:00:00,5,5,1,4,8,BTC,-4,4,2021,12,4
2021-12-12 09:41:58,5,12,0,17,0,BTC,17,12,2021,12,4
2021-12-12 11:30:29,4,6,11,5,11,BTC,-6,-5,2021,12,4
2021-12-12 20:04:50,3,5,1,1,5,BTC,-4,4,2021,12,4
2021-12-12 20:28:46,4,6,0,3,4,BTC,-1,6,2021,12,4
2021-12-13 00:30:42,5,10,1,9,0,BTC,9,9,2021,12,4
2021-12-13 12:23:16,3,7,0,8,1,BTC,7,7,2021,12,4
2021-12-13 13:45:54,4,7,0,12,0,BTC,12,7,2021,12,4
2021-12-13 14:39:47,14,23,50,27,49,BTC,-22,-27,2021,12,4
2021-12-13 17:15:41,3,4,0,4,1,BTC,3,4,2021,12,4
2021-12-13 23:00:34,4,6,1,8,1,BTC,7,5,2021,12,4
2021-12-14 04:10:10,8,14,3,21,5,BTC,16,11,2021,12,4
2021-12-14 09:09:14,6,8,5,11,3,BTC,8,3,2021,12,4
2021-12-14 12:06:31,5,6,6,16,7,BTC,9,0,2021,12,4
2021-12-14 12:21:45,31,47,4,68,6,BTC,62,43,2021,12,4
2021-12-15 08:54:51,5,6,1,6,1,BTC,5,5,2021,12,4
2021-12-15 12:45:09,11,25,0,31,0,BTC,31,25,2021,12,4
2021-12-16 09:46:00,3,5,0,6,0,BTC,6,5,2021,12,4
2021-12-16 10:45:51,4,9,10,17,5,BTC,12,-1,2021,12,4
2021-12-16 13:14:07,3,13,7,12,11,BTC,1,6,2021,12,4
2021-12-16 15:12:00,4,4,1,5,1,BTC,4,3,2021,12,4
2021-12-16 16:04:17,21,11,13,16,31,BTC,-15,-2,2021,12,4
2021-12-17 03:08:26,4,4,0,4,2,BTC,2,4,2021,12,4
2021-12-17 12:00:00,5,5,0,8,0,BTC,8,5,2021,12,4
2021-12-17 12:02:18,3,6,1,7,1,BTC,6,5,2021,12,4
2021-12-17 13:35:53,8,17,1,28,5,BTC,23,16,2021,12,4
2021-12-17 13:46:47,3,0,3,3,6,BTC,-3,-3,2021,12,4
2021-12-17 16:39:44,14,19,0,34,1,BTC,33,19,2021,12,4
2021-12-18 00:15:12,9,13,5,20,12,BTC,8,8,2021,12,4
2021-12-18 12:30:30,27,9,18,19,40,BTC,-21,-9,2021,12,4
2021-12-18 21:19:17,14,30,5,43,3,BTC,40,25,2021,12,4
2021-12-19 15:38:45,10,21,8,27,2,BTC,25,13,2021,12,4
2021-12-20 03:28:53,9,14,5,25,2,BTC,23,9,2021,12,4
2021-12-20 14:28:06,4,9,5,12,11,BTC,1,4,2021,12,4
2021-12-20 23:30:00,7,16,1,20,3,BTC,17,15,2021,12,4
2021-12-21 03:08:39,4,11,1,9,2,BTC,7,10,2021,12,4
2021-12-21 09:28:13,4,5,0,7,1,BTC,6,5,2021,12,4
2021-12-21 10:05:46,4,6,0,8,0,BTC,8,6,2021,12,4
2021-12-21 11:44:11,4,6,1,8,1,BTC,7,5,2021,12,4
2021-12-21 13:30:37,4,8,6,11,17,BTC,-6,2,2021,12,4
2021-12-21 13:34:09,5,4,4,6,12,BTC,-6,0,2021,12,4
2021-12-21 14:25:01,9,14,1,18,0,BTC,18,13,2021,12,4
2021-12-21 15:27:06,7,14,0,20,0,BTC,20,14,2021,12,4
2021-12-21 20:44:00,3,4,1,4,1,BTC,3,3,2021,12,4
2021-12-21 21:00:37,15,30,7,38,7,BTC,31,23,2021,12,4
2021-12-22 04:08:32,6,13,2,16,4,BTC,12,11,2021,12,4
2021-12-22 09:00:00,3,3,1,3,0,BTC,3,2,2021,12,4
2021-12-22 10:45:59,5,0,4,2,3,BTC,-1,-4,2021,12,4
2021-12-22 12:01:38,3,0,3,2,5,BTC,-3,-3,2021,12,4
2021-12-23 10:15:29,3,5,0,5,0,BTC,5,5,2021,12,4
2021-12-23 12:45:51,3,8,1,11,1,BTC,10,7,2021,12,4
2021-12-23 15:25:00,5,7,3,8,2,BTC,6,4,2021,12,4
2021-12-23 17:38:07,13,33,0,47,3,BTC,44,33,2021,12,4
2021-12-23 18:00:42,10,24,39,30,23,BTC,7,-15,2021,12,4
2021-12-24 03:08:46,4,8,0,10,2,BTC,8,8,2021,12,4
2021-12-24 13:13:39,3,4,2,4,3,BTC,1,2,2021,12,4
2021-12-24 23:45:46,3,2,6,2,6,BTC,-4,-4,2021,12,4
2021-12-25 03:15:27,4,8,0,6,0,BTC,6,8,2021,12,4
2021-12-25 08:04:12,4,9,4,11,3,BTC,8,5,2021,12,4
2021-12-25 09:33:35,12,16,7,20,8,BTC,12,9,2021,12,4
2021-12-25 10:30:14,8,11,0,10,0,BTC,10,11,2021,12,4
2021-12-25 12:11:19,5,9,0,11,0,BTC,11,9,2021,12,4
2021-12-25 15:20:36,6,7,0,14,1,BTC,13,7,2021,12,4
2021-12-25 17:55:07,3,6,1,4,1,BTC,3,5,2021,12,4
2021-12-25 21:00:31,17,35,4,42,6,BTC,36,31,2021,12,4
2021-12-26 08:29:26,7,12,3,14,2,BTC,12,9,2021,12,4
2021-12-26 10:45:00,4,9,0,14,0,BTC,14,9,2021,12,4
2021-12-26 19:14:42,24,55,3,55,2,BTC,53,52,2021,12,4
2021-12-26 21:30:25,4,16,1,18,2,BTC,16,15,2021,12,4
2021-12-27 05:38:50,5,27,1,39,2,BTC,37,26,2021,12,4
2021-12-27 08:51:27,7,10,0,9,8,BTC,1,10,2021,12,4
2021-12-27 10:09:09,7,4,4,6,6,BTC,0,0,2021,12,4
2021-12-27 12:59:47,5,7,1,7,1,BTC,6,6,2021,12,4
2021-12-27 15:00:46,5,7,0,8,0,BTC,8,7,2021,12,4
2021-12-27 16:00:10,5,4,3,3,8,BTC,-5,1,2021,12,4
2021-12-27 18:14:57,7,11,0,15,0,BTC,15,11,2021,12,4
2021-12-27 19:00:32,4,2,2,1,3,BTC,-2,0,2021,12,4
2021-12-27 23:00:14,4,6,0,7,0,BTC,7,6,2021,12,4
2021-12-27 23:00:26,13,23,3,25,5,BTC,20,20,2021,12,4
2021-12-28 10:54:36,5,2,1,1,6,BTC,-5,1,2021,12,4
2021-12-28 14:41:45,3,9,20,5,26,BTC,-21,-11,2021,12,4
2021-12-28 17:00:53,5,10,0,6,1,BTC,5,10,2021,12,4
2021-12-28 19:11:07,3,16,1,21,8,BTC,13,15,2021,12,4
2021-12-28 19:59:21,3,3,1,3,5,BTC,-2,2,2021,12,4
2021-12-28 23:30:52,4,6,0,6,1,BTC,5,6,2021,12,4
2021-12-29 08:04:01,4,8,2,7,1,BTC,6,6,2021,12,4
2021-12-29 11:30:54,7,3,5,2,19,BTC,-17,-2,2021,12,4
2021-12-29 20:52:27,3,1,4,2,4,BTC,-2,-3,2021,12,4
2021-12-30 11:15:49,3,2,5,3,9,BTC,-6,-3,2021,12,4
2021-12-30 18:49:36,4,13,1,12,1,BTC,11,12,2021,12,4
2021-12-30 19:45:08,3,2,2,2,5,BTC,-3,0,2021,12,4
2021-12-30 20:02:16,11,3,2,2,3,BTC,-1,1,2021,12,4
2021-12-31 02:59:59,4,9,0,14,0,BTC,14,9,2021,12,4
2021-12-31 23:01:01,5,8,4,10,3,BTC,7,4,2021,12,4
2022-01-01 16:55:09,5,7,4,9,4,BTC,5,3,2022,1,1
2022-01-03 11:52:53,17,31,1,38,6,BTC,32,30,2022,1,1
2022-01-03 15:17:31,3,3,2,3,2,BTC,1,1,2022,1,1
2022-01-04 10:37:29,5,7,2,8,2,BTC,6,5,2022,1,1
2022-01-04 14:55:13,4,4,1,6,3,BTC,3,3,2022,1,1
2022-01-04 18:00:51,5,1,9,2,4,BTC,-2,-8,2022,1,1
2022-01-04 23:19:46,7,8,2,11,3,BTC,8,6,2022,1,1
2022-01-04 23:30:12,3,2,1,3,1,BTC,2,1,2022,1,1
2022-01-05 14:04:07,3,1,3,2,7,BTC,-5,-2,2022,1,1
2022-01-05 16:51:33,5,11,1,18,0,BTC,18,10,2022,1,1
2022-01-05 17:05:32,4,4,6,4,5,BTC,-1,-2,2022,1,1
2022-01-05 20:30:00,30,9,13,11,46,BTC,-35,-4,2022,1,1
2022-01-05 21:47:26,10,7,6,7,31,BTC,-24,1,2022,1,1
2022-01-05 22:15:13,15,20,22,23,32,BTC,-9,-2,2022,1,1
2022-01-05 23:34:59,3,1,4,2,8,BTC,-6,-3,2022,1,1
2022-01-06 03:08:43,7,11,13,16,27,BTC,-11,-2,2022,1,1
2022-01-06 09:26:15,5,5,3,2,9,BTC,-7,2,2022,1,1
2022-01-06 19:35:52,3,0,3,0,6,BTC,-6,-3,2022,1,1
2022-01-07 06:54:37,16,15,6,13,22,BTC,-9,9,2022,1,1
2022-01-07 09:29:59,6,3,7,2,5,BTC,-3,-4,2022,1,1
2022-01-07 10:45:33,4,8,4,11,6,BTC,5,4,2022,1,1
2022-01-07 15:53:38,5,2,4,3,9,BTC,-6,-2,2022,1,1
2022-01-07 18:30:31,3,7,0,8,0,BTC,8,7,2022,1,1
2022-01-07 22:00:09,22,37,5,44,5,BTC,39,32,2022,1,1
2022-01-07 22:43:49,5,8,1,10,2,BTC,8,7,2022,1,1
2022-01-08 01:20:00,24,50,0,63,3,BTC,60,50,2022,1,1
2022-01-08 15:21:40,9,17,15,27,29,BTC,-2,2,2022,1,1
2022-01-08 23:05:21,21,32,1,36,1,BTC,35,31,2022,1,1
2022-01-09 12:30:03,4,7,0,8,0,BTC,8,7,2022,1,1
2022-01-09 13:53:09,3,1,5,3,13,BTC,-10,-4,2022,1,1
2022-01-09 19:30:16,10,28,8,32,18,BTC,14,20,2022,1,1
2022-01-09 23:15:33,3,10,0,10,1,BTC,9,10,2022,1,1
2022-01-10 10:35:05,10,15,0,21,2,BTC,19,15,2022,1,1
2022-01-10 14:47:14,3,2,2,7,2,BTC,5,0,2022,1,1
2022-01-10 15:08:20,11,15,4,29,11,BTC,18,11,2022,1,1
2022-01-11 08:04:09,5,9,0,13,0,BTC,13,9,2022,1,1
2022-01-11 13:54:26,18,8,17,9,27,BTC,-18,-9,2022,1,1
2022-01-11 14:34:11,3,4,0,2,0,BTC,2,4,2022,1,1
2022-01-11 20:25:04,5,5,0,6,0,BTC,6,5,2022,1,1
2022-01-12 00:45:22,4,9,0,8,0,BTC,8,9,2022,1,1
2022-01-12 11:24:22,12,14,0,22,2,BTC,20,14,2022,1,1
2022-01-12 11:31:53,4,8,0,11,2,BTC,9,8,2022,1,1
2022-01-12 13:36:47,9,7,11,10,15,BTC,-5,-4,2022,1,1
2022-01-12 15:30:26,20,31,3,40,3,BTC,37,28,2022,1,1
2022-01-13 09:36:06,38,59,0,90,2,BTC,88,59,2022,1,1
2022-01-13 11:30:56,3,5,0,5,0,BTC,5,5,2022,1,1
2022-01-13 13:51:16,3,7,0,8,1,BTC,7,7,2022,1,1
2022-01-13 15:03:33,20,34,3,49,5,BTC,44,31,2022,1,1
2022-01-13 20:00:21,11,20,13,32,12,BTC,20,7,2022,1,1
2022-01-14 02:54:31,3,3,0,4,4,BTC,0,3,2022,1,1
2022-01-14 13:30:42,4,7,14,13,18,BTC,-5,-7,2022,1,1
2022-01-14 17:25:02,4,11,0,13,0,BTC,13,11,2022,1,1
2022-01-14 21:35:00,7,17,8,21,10,BTC,11,9,2022,1,1
2022-01-15 09:50:15,29,43,4,49,6,BTC,43,39,2022,1,1
2022-01-15 09:53:35,5,3,2,4,8,BTC,-4,1,2022,1,1
2022-01-15 14:01:03,13,33,3,46,2,BTC,44,30,2022,1,1
2022-01-16 09:11:04,31,54,7,64,9,BTC,55,47,2022,1,1
2022-01-16 10:15:53,3,9,0,11,0,BTC,11,9,2022,1,1
2022-01-16 12:45:10,6,8,1,10,1,BTC,9,7,2022,1,1
2022-01-16 18:07:45,22,32,44,40,57,BTC,-17,-12,2022,1,1
2022-01-16 19:32:39,3,5,0,3,0,BTC,3,5,2022,1,1
2022-01-17 03:27:00,16,27,4,34,5,BTC,29,23,2022,1,1
2022-01-17 09:10:17,17,25,5,32,6,BTC,26,20,2022,1,1
2022-01-17 09:17:28,12,17,3,23,4,BTC,19,14,2022,1,1
2022-01-17 10:09:45,6,3,3,1,7,BTC,-6,0,2022,1,1
2022-01-17 12:28:35,54,10,18,7,38,BTC,-31,-8,2022,1,1
2022-01-17 17:00:00,7,9,1,14,1,BTC,13,8,2022,1,1
2022-01-17 19:00:25,4,7,0,10,0,BTC,10,7,2022,1,1
2022-01-17 20:09:39,14,6,10,8,8,BTC,0,-4,2022,1,1
2022-01-17 22:00:23,9,15,3,23,4,BTC,19,12,2022,1,1
2022-01-17 23:30:00,4,2,2,5,2,BTC,3,0,2022,1,1
2022-01-18 10:43:17,12,9,22,9,24,BTC,-15,-13,2022,1,1
2022-01-18 13:39:51,8,3,2,3,4,BTC,-1,1,2022,1,1
2022-01-18 19:30:00,19,24,3,30,5,BTC,25,21,2022,1,1
2022-01-18 21:06:53,6,6,3,2,4,BTC,-2,3,2022,1,1
2022-01-19 05:40:45,4,4,0,4,1,BTC,3,4,2022,1,1
2022-01-19 08:04:26,8,9,2,17,0,BTC,17,7,2022,1,1
2022-01-19 09:20:07,6,4,7,3,13,BTC,-10,-3,2022,1,1
2022-01-19 11:43:52,19,18,16,22,24,BTC,-2,2,2022,1,1
2022-01-19 12:45:31,4,6,3,6,4,BTC,2,3,2022,1,1
2022-01-19 14:11:52,7,12,2,16,3,BTC,13,10,2022,1,1
2022-01-19 16:00:00,11,18,3,24,5,BTC,19,15,2022,1,1
2022-01-19 20:48:11,4,9,0,11,1,BTC,10,9,2022,1,1
2022-01-19 21:00:17,6,19,2,19,4,BTC,15,17,2022,1,1
2022-01-20 00:15:57,3,6,0,7,2,BTC,5,6,2022,1,1
2022-01-20 14:00:00,4,3,0,1,0,BTC,1,3,2022,1,1
2022-01-20 15:09:28,3,4,5,3,8,BTC,-5,-1,2022,1,1
2022-01-20 15:23:33,8,19,1,27,2,BTC,25,18,2022,1,1
2022-01-20 21:30:33,30,22,29,28,70,BTC,-42,-7,2022,1,1
2022-01-20 21:54:33,11,15,20,15,35,BTC,-20,-5,2022,1,1
2022-01-21 04:15:18,6,9,0,5,16,BTC,-11,9,2022,1,1
2022-01-21 05:47:34,5,1,1,2,9,BTC,-7,0,2022,1,1
2022-01-21 06:03:24,10,18,1,14,16,BTC,-2,17,2022,1,1
2022-01-21 09:21:49,13,12,14,17,25,BTC,-8,-2,2022,1,1
2022-01-21 09:49:32,3,2,2,3,4,BTC,-1,0,2022,1,1
2022-01-21 20:11:41,3,6,1,5,0,BTC,5,5,2022,1,1
2022-01-21 20:30:25,3,7,1,10,0,BTC,10,6,2022,1,1
2022-01-21 22:07:06,7,20,9,18,19,BTC,-1,11,2022,1,1
2022-01-21 23:00:22,12,28,0,35,0,BTC,35,28,2022,1,1
2022-01-22 08:04:48,7,1,0,4,1,BTC,3,1,2022,1,1
2022-01-22 08:58:24,4,5,0,7,1,BTC,6,5,2022,1,1
2022-01-22 10:00:45,10,10,1,7,14,BTC,-7,9,2022,1,1
2022-01-22 23:30:00,3,7,4,6,10,BTC,-4,3,2022,1,1
2022-01-23 09:53:48,5,5,0,4,2,BTC,2,5,2022,1,1
2022-01-23 18:31:27,4,3,0,0,1,BTC,-1,3,2022,1,1
2022-01-23 19:46:51,3,4,0,5,0,BTC,5,4,2022,1,1
2022-01-23 23:05:44,4,8,1,8,4,BTC,4,7,2022,1,1
2022-01-24 08:35:31,17,10,8,8,30,BTC,-22,2,2022,1,1
2022-01-24 09:46:08,3,2,1,1,8,BTC,-7,1,2022,1,1
2022-01-24 12:24:12,8,6,4,8,7,BTC,1,2,2022,1,1
2022-01-24 12:29:00,3,5,1,5,7,BTC,-2,4,2022,1,1
2022-01-24 14:42:00,16,7,12,8,27,BTC,-19,-5,2022,1,1
2022-01-24 18:03:42,9,19,2,21,3,BTC,18,17,2022,1,1
2022-01-25 00:37:35,8,3,8,3,19,BTC,-16,-5,2022,1,1
2022-01-25 03:18:14,3,6,1,6,1,BTC,5,5,2022,1,1
2022-01-25 10:19:40,3,4,0,5,2,BTC,3,4,2022,1,1
2022-01-25 14:00:00,3,7,0,8,0,BTC,8,7,2022,1,1
2022-01-25 19:10:46,11,1,11,6,23,BTC,-17,-10,2022,1,1
2022-01-25 19:41:06,5,6,0,8,0,BTC,8,6,2022,1,1
2022-01-25 19:44:35,3,2,0,5,0,BTC,5,2,2022,1,1
2022-01-25 21:30:10,3,8,0,12,0,BTC,12,8,2022,1,1
2022-01-25 22:50:00,4,5,1,4,1,BTC,3,4,2022,1,1
2022-01-25 22:58:52,4,5,1,5,0,BTC,5,4,2022,1,1
2022-01-26 11:36:35,7,4,6,7,9,BTC,-2,-2,2022,1,1
2022-01-26 14:08:51,17,20,0,31,0,BTC,31,20,2022,1,1
2022-01-26 19:01:36,9,7,0,10,0,BTC,10,7,2022,1,1
2022-01-26 19:07:54,15,17,0,24,4,BTC,20,17,2022,1,1
2022-01-26 21:15:00,6,10,0,12,0,BTC,12,10,2022,1,1
2022-01-27 00:15:52,7,8,0,11,0,BTC,11,8,2022,1,1
2022-01-27 12:49:49,3,8,0,9,0,BTC,9,8,2022,1,1
2022-01-27 13:36:40,6,6,0,11,0,BTC,11,6,2022,1,1
2022-01-27 15:39:58,17,9,15,8,36,BTC,-28,-6,2022,1,1
2022-01-27 16:30:00,4,4,4,5,12,BTC,-7,0,2022,1,1
2022-01-27 22:00:18,73,29,26,42,73,BTC,-31,3,2022,1,1
2022-01-27 22:12:36,4,1,3,0,10,BTC,-10,-2,2022,1,1
2022-01-28 10:20:22,3,2,9,2,10,BTC,-8,-7,2022,1,1
2022-01-28 12:16:40,3,3,0,4,1,BTC,3,3,2022,1,1
2022-01-28 15:43:25,9,18,0,21,1,BTC,20,18,2022,1,1
2022-01-28 18:25:27,4,3,3,1,12,BTC,-11,0,2022,1,1
2022-01-28 21:00:00,3,7,0,5,1,BTC,4,7,2022,1,1
2022-01-29 03:39:00,15,15,37,37,24,BTC,13,-22,2022,1,1
2022-01-29 08:17:28,4,3,1,1,6,BTC,-5,2,2022,1,1
2022-01-29 17:51:12,20,33,1,49,1,BTC,48,32,2022,1,1
2022-01-29 21:30:19,3,8,11,7,0,BTC,7,-3,2022,1,1
2022-01-30 10:15:09,3,5,1,3,1,BTC,2,4,2022,1,1
2022-01-30 11:57:34,24,37,1,55,3,BTC,52,36,2022,1,1
2022-01-30 13:04:08,3,4,1,7,1,BTC,6,3,2022,1,1
2022-01-30 15:41:00,5,7,0,9,1,BTC,8,7,2022,1,1
2022-01-30 16:38:11,14,17,2,25,4,BTC,21,15,2022,1,1
2022-01-31 03:11:50,4,6,1,10,2,BTC,8,5,2022,1,1
2022-01-31 16:31:00,5,8,3,10,2,BTC,8,5,2022,1,1
2022-01-31 21:15:00,10,25,0,30,2,BTC,28,25,2022,1,1
2022-01-31 23:30:00,4,9,0,11,3,BTC,8,9,2022,1,1
2022-02-01 06:39:52,8,17,0,24,1,BTC,23,17,2022,2,1
2022-02-01 09:04:01,12,6,5,6,17,BTC,-11,1,2022,2,1
2022-02-01 09:27:28,7,0,2,1,15,BTC,-14,-2,2022,2,1
2022-02-01 14:47:08,12,1,11,3,20,BTC,-17,-10,2022,2,1
2022-02-02 10:22:08,8,4,3,4,6,BTC,-2,1,2022,2,1
2022-02-02 14:29:40,3,4,0,2,1,BTC,1,4,2022,2,1
2022-02-02 21:45:00,3,6,1,4,6,BTC,-2,5,2022,2,1
2022-02-03 09:13:44,11,13,2,22,3,BTC,19,11,2022,2,1
2022-02-03 09:46:32,3,2,6,2,10,BTC,-8,-4,2022,2,1
2022-02-03 11:09:11,7,2,5,0,11,BTC,-11,-3,2022,2,1
2022-02-03 17:03:11,6,3,3,7,1,BTC,6,0,2022,2,1
2022-02-03 22:35:30,5,1,7,1,5,BTC,-4,-6,2022,2,1
2022-02-04 06:20:01,4,3,2,4,1,BTC,3,1,2022,2,1
2022-02-04 15:14:48,11,6,21,5,18,BTC,-13,-15,2022,2,1
2022-02-04 16:53:00,5,8,0,10,0,BTC,10,8,2022,2,1
2022-02-04 20:38:00,3,4,3,2,5,BTC,-3,1,2022,2,1
2022-02-04 22:46:46,3,8,1,7,2,BTC,5,7,2022,2,1
2022-02-05 09:15:00,8,12,0,15,0,BTC,15,12,2022,2,1
2022-02-05 09:41:51,12,21,0,25,0,BTC,25,21,2022,2,1
2022-02-05 11:15:23,12,21,11,24,11,BTC,13,10,2022,2,1
2022-02-05 16:13:49,6,9,0,6,0,BTC,6,9,2022,2,1
2022-02-06 12:45:37,3,6,0,5,0,BTC,5,6,2022,2,1
2022-02-06 14:46:38,7,7,0,8,0,BTC,8,7,2022,2,1
2022-02-06 19:45:46,4,14,2,11,0,BTC,11,12,2022,2,1
2022-02-06 23:38:31,3,8,0,14,0,BTC,14,8,2022,2,1
2022-02-07 10:01:51,3,2,3,1,4,BTC,-3,-1,2022,2,1
2022-02-07 11:21:12,6,9,0,13,0,BTC,13,9,2022,2,1
2022-02-07 14:36:28,3,6,0,5,0,BTC,5,6,2022,2,1
2022-02-07 16:11:00,5,6,0,11,1,BTC,10,6,2022,2,1
2022-02-07 16:36:06,10,25,0,34,0,BTC,34,25,2022,2,1
2022-02-07 17:28:11,6,7,0,13,0,BTC,13,7,2022,2,1
2022-02-07 19:11:17,28,32,0,52,0,BTC,52,32,2022,2,1
2022-02-07 23:45:09,6,5,0,7,1,BTC,6,5,2022,2,1
2022-02-08 00:01:44,4,5,0,6,0,BTC,6,5,2022,2,1
2022-02-08 09:09:05,4,4,0,6,0,BTC,6,4,2022,2,1
2022-02-08 21:00:47,3,8,1,12,2,BTC,10,7,2022,2,1
2022-02-09 13:34:47,4,2,1,1,3,BTC,-2,1,2022,2,1
2022-02-09 14:00:25,3,4,0,4,0,BTC,4,4,2022,2,1
2022-02-09 15:29:29,11,4,8,14,14,BTC,0,-4,2022,2,1
2022-02-10 14:00:31,10,15,4,19,5,BTC,14,11,2022,2,1
2022-02-10 14:07:44,3,2,1,4,1,BTC,3,1,2022,2,1
2022-02-10 15:30:12,4,5,0,6,0,BTC,6,5,2022,2,1
2022-02-10 17:00:37,5,8,0,10,0,BTC,10,8,2022,2,1
2022-02-10 17:55:39,5,6,0,10,0,BTC,10,6,2022,2,1
2022-02-10 18:00:33,7,5,1,3,1,BTC,2,4,2022,2,1
2022-02-10 23:00:36,4,5,0,6,0,BTC,6,5,2022,2,1
2022-02-10 23:05:11,4,4,0,7,0,BTC,7,4,2022,2,1
2022-02-11 02:00:30,19,31,6,34,7,BTC,27,25,2022,2,1
2022-02-11 03:08:06,3,4,0,7,0,BTC,7,4,2022,2,1
2022-02-11 14:30:00,4,4,0,7,0,BTC,7,4,2022,2,1
2022-02-11 14:45:36,3,3,0,3,0,BTC,3,3,2022,2,1
2022-02-11 18:39:52,13,4,17,7,19,BTC,-12,-13,2022,2,1
2022-02-11 22:00:18,5,4,2,6,9,BTC,-3,2,2022,2,1
2022-02-12 11:15:01,13,21,0,24,1,BTC,23,21,2022,2,1
2022-02-12 17:55:28,4,7,1,7,0,BTC,7,6,2022,2,1
2022-02-13 11:52:20,29,46,9,56,7,BTC,49,37,2022,2,1
2022-02-13 20:55:00,14,28,1,34,2,BTC,32,27,2022,2,1
2022-02-14 13:00:42,3,3,2,2,6,BTC,-4,1,2022,2,1
2022-02-14 13:40:44,3,3,0,4,0,BTC,4,3,2022,2,1
2022-02-14 16:25:00,3,6,0,8,0,BTC,8,6,2022,2,1
2022-02-14 21:20:33,4,1,2,2,8,BTC,-6,-1,2022,2,1
2022-02-14 23:00:56,3,4,0,3,0,BTC,3,4,2022,2,1
2022-02-14 23:01:43,4,9,0,7,0,BTC,7,9,2022,2,1
2022-02-15 02:00:55,5,7,1,10,1,BTC,9,6,2022,2,1
2022-02-15 09:44:50,3,5,1,8,1,BTC,7,4,2022,2,1
2022-02-15 10:23:55,5,6,1,9,0,BTC,9,5,2022,2,1
2022-02-15 11:46:02,7,10,0,17,0,BTC,17,10,2022,2,1
2022-02-15 13:07:34,6,5,4,2,10,BTC,-8,1,2022,2,1
2022-02-15 17:00:00,4,6,1,8,0,BTC,8,5,2022,2,1
2022-02-15 18:39:56,12,16,0,22,0,BTC,22,16,2022,2,1
2022-02-15 19:30:25,3,10,0,10,0,BTC,10,10,2022,2,1
2022-02-16 04:43:41,3,2,0,0,0,BTC,0,2,2022,2,1
2022-02-16 10:44:41,23,13,21,11,12,BTC,-1,-8,2022,2,1
2022-02-16 11:56:27,7,5,0,12,0,BTC,12,5,2022,2,1
2022-02-16 13:23:14,6,7,0,9,0,BTC,9,7,2022,2,1
2022-02-16 15:25:04,6,6,1,2,9,BTC,-7,5,2022,2,1
2022-02-16 15:32:49,4,1,2,2,2,BTC,0,-1,2022,2,1
2022-02-16 16:04:33,8,10,1,13,0,BTC,13,9,2022,2,1
2022-02-16 19:45:17,4,4,0,7,0,BTC,7,4,2022,2,1
2022-02-16 19:53:38,19,21,2,38,1,BTC,37,19,2022,2,1
2022-02-17 02:25:22,4,1,2,0,3,BTC,-3,-1,2022,2,1
2022-02-17 11:08:08,7,0,1,2,5,BTC,-3,-1,2022,2,1
2022-02-17 12:00:18,5,7,0,13,0,BTC,13,7,2022,2,1
2022-02-17 17:59:44,6,6,3,8,1,BTC,7,3,2022,2,1
2022-02-17 18:17:49,14,4,3,6,8,BTC,-2,1,2022,2,1
2022-02-17 19:47:00,6,13,3,16,2,BTC,14,10,2022,2,1
2022-02-18 14:05:00,9,6,1,9,1,BTC,8,5,2022,2,1
2022-02-18 17:17:34,15,15,30,15,29,BTC,-14,-15,2022,2,1
2022-02-18 19:48:27,9,2,2,2,9,BTC,-7,0,2022,2,1
2022-02-18 23:35:00,4,0,2,1,6,BTC,-5,-2,2022,2,1
2022-02-19 00:15:33,28,32,0,49,2,BTC,47,32,2022,2,1
2022-02-19 08:45:19,3,1,2,1,1,BTC,0,-1,2022,2,1
2022-02-19 12:55:36,7,4,1,8,4,BTC,4,3,2022,2,1
2022-02-20 08:11:33,5,2,7,2,11,BTC,-9,-5,2022,2,1
2022-02-20 09:10:36,10,2,8,7,8,BTC,-1,-6,2022,2,1
2022-02-20 14:03:34,3,2,2,1,6,BTC,-5,0,2022,2,1
2022-02-20 17:19:56,4,4,0,7,0,BTC,7,4,2022,2,1
2022-02-21 10:50:58,8,7,4,6,6,BTC,0,3,2022,2,1
2022-02-21 11:10:39,3,2,2,1,4,BTC,-3,0,2022,2,1
2022-02-21 12:53:27,12,14,0,23,0,BTC,23,14,2022,2,1
2022-02-21 17:47:34,10,5,9,7,14,BTC,-7,-4,2022,2,1
2022-02-21 19:30:26,9,6,9,5,15,BTC,-10,-3,2022,2,1
2022-02-22 04:01:41,7,8,3,11,4,BTC,7,5,2022,2,1
2022-02-22 12:24:01,3,3,2,5,1,BTC,4,1,2022,2,1
2022-02-22 14:20:14,11,22,6,26,7,BTC,19,16,2022,2,1
2022-02-22 16:00:29,4,6,0,8,0,BTC,8,6,2022,2,1
2022-02-22 17:04:28,3,7,1,8,1,BTC,7,6,2022,2,1
2022-02-22 17:19:04,3,5,0,5,0,BTC,5,5,2022,2,1
2022-02-22 21:36:44,4,6,0,8,0,BTC,8,6,2022,2,1
2022-02-22 21:38:28,6,8,0,7,0,BTC,7,8,2022,2,1
2022-02-23 03:20:00,6,8,1,20,2,BTC,18,7,2022,2,1
2022-02-23 13:36:55,4,6,2,6,2,BTC,4,4,2022,2,1
2022-02-23 14:37:18,4,2,1,5,1,BTC,4,1,2022,2,1
2022-02-23 15:37:24,7,6,2,5,6,BTC,-1,4,2022,2,1
2022-02-23 21:57:14,5,2,2,1,3,BTC,-2,0,2022,2,1
2022-02-24 04:34:43,21,3,14,6,47,BTC,-41,-11,2022,2,1
2022-02-24 04:46:51,7,1,2,3,11,BTC,-8,-1,2022,2,1
2022-02-24 08:25:09,4,2,2,3,6,BTC,-3,0,2022,2,1
2022-02-24 08:45:16,12,2,4,9,21,BTC,-12,-2,2022,2,1
2022-02-24 09:51:28,3,3,1,1,3,BTC,-2,2,2022,2,1
2022-02-24 10:44:33,6,3,6,3,8,BTC,-5,-3,2022,2,1
2022-02-24 10:50:07,3,2,1,4,1,BTC,3,1,2022,2,1
2022-02-24 11:04:39,7,2,7,2,7,BTC,-5,-5,2022,2,1
2022-02-24 12:49:30,12,16,1,22,4,BTC,18,15,2022,2,1
2022-02-24 23:24:56,7,5,9,2,16,BTC,-14,-4,2022,2,1
2022-02-25 04:00:02,23,12,23,11,45,BTC,-34,-11,2022,2,1
2022-02-25 15:40:32,3,5,0,8,0,BTC,8,5,2022,2,1
2022-02-25 18:16:33,3,1,0,6,2,BTC,4,1,2022,2,1
2022-02-25 20:07:51,4,7,6,12,18,BTC,-6,1,2022,2,1
2022-02-26 00:45:53,7,10,0,13,0,BTC,13,10,2022,2,1
2022-02-26 09:58:35,3,4,1,8,1,BTC,7,3,2022,2,1
2022-02-26 14:46:31,3,7,1,10,1,BTC,9,6,2022,2,1
2022-02-26 15:52:12,8,10,3,9,4,BTC,5,7,2022,2,1
2022-02-26 19:45:41,3,5,1,6,3,BTC,3,4,2022,2,1
2022-02-27 05:00:00,5,11,1,23,2,BTC,21,10,2022,2,1
2022-02-27 10:45:46,9,15,1,16,1,BTC,15,14,2022,2,1
2022-02-27 13:28:18,4,3,7,4,8,BTC,-4,-4,2022,2,1
2022-02-27 18:16:45,12,22,2,16,1,BTC,15,20,2022,2,1
2022-02-27 18:39:39,42,58,1,90,5,BTC,85,57,2022,2,1
2022-02-27 21:12:00,3,10,0,12,0,BTC,12,10,2022,2,1
2022-02-28 01:24:41,14,10,10,10,16,BTC,-6,0,2022,2,1
2022-02-28 07:08:38,4,12,4,8,7,BTC,1,8,2022,2,1
2022-02-28 14:47:26,42,56,0,89,2,BTC,87,56,2022,2,1
2022-02-28 17:01:33,5,8,0,13,0,BTC,13,8,2022,2,1
2022-02-28 18:00:11,4,6,0,7,0,BTC,7,6,2022,2,1
2022-02-28 19:52:06,6,5,0,3,0,BTC,3,5,2022,2,1
2022-03-01 11:44:28,3,4,0,7,0,BTC,7,4,2022,3,1
2022-03-01 12:35:37,8,7,0,10,0,BTC,10,7,2022,3,1
2022-03-01 17:50:00,7,11,5,17,6,BTC,11,6,2022,3,1
2022-03-01 19:25:53,9,11,1,14,1,BTC,13,10,2022,3,1
2022-03-01 21:00:12,10,15,0,18,1,BTC,17,15,2022,3,1
2022-03-01 21:00:55,5,16,0,10,0,BTC,10,16,2022,3,1
2022-03-02 09:59:02,4,3,4,2,12,BTC,-10,-1,2022,3,1
2022-03-02 12:14:58,5,6,0,7,1,BTC,6,6,2022,3,1
2022-03-02 14:00:11,3,3,1,3,1,BTC,2,2,2022,3,1
2022-03-02 14:39:45,3,3,0,3,0,BTC,3,3,2022,3,1
2022-03-02 16:37:50,6,8,2,9,5,BTC,4,6,2022,3,1
2022-03-02 20:46:12,4,10,1,10,2,BTC,8,9,2022,3,1
2022-03-02 23:45:02,5,3,1,3,3,BTC,0,2,2022,3,1
2022-03-03 11:13:43,4,4,2,3,12,BTC,-9,2,2022,3,1
2022-03-03 14:51:00,3,3,3,5,7,BTC,-2,0,2022,3,1
2022-03-03 17:43:42,18,30,0,39,0,BTC,39,30,2022,3,1
2022-03-03 18:25:32,11,17,0,23,0,BTC,23,17,2022,3,1
2022-03-03 22:16:57,26,37,0,58,3,BTC,55,37,2022,3,1
2022-03-03 22:34:03,4,2,1,1,3,BTC,-2,1,2022,3,1
2022-03-04 00:00:00,4,9,0,6,0,BTC,6,9,2022,3,1
2022-03-04 11:00:46,5,0,2,2,9,BTC,-7,-2,2022,3,1
2022-03-04 14:09:07,4,0,2,1,8,BTC,-7,-2,2022,3,1
2022-03-04 15:12:52,27,36,0,56,3,BTC,53,36,2022,3,1
2022-03-04 15:29:06,7,13,5,25,17,BTC,8,8,2022,3,1
2022-03-05 00:30:42,3,5,1,7,4,BTC,3,4,2022,3,1
2022-03-05 01:00:20,3,4,1,5,1,BTC,4,3,2022,3,1
2022-03-05 07:29:05,3,5,0,8,0,BTC,8,5,2022,3,1
2022-03-05 09:45:22,3,5,1,3,6,BTC,-3,4,2022,3,1
2022-03-05 11:52:42,17,10,22,13,26,BTC,-13,-12,2022,3,1
2022-03-05 12:13:54,15,23,21,10,34,BTC,-24,2,2022,3,1
2022-03-05 16:06:19,6,3,1,6,4,BTC,2,2,2022,3,1
2022-03-06 01:28:12,3,3,1,2,1,BTC,1,2,2022,3,1
2022-03-06 10:46:40,3,3,3,3,10,BTC,-7,0,2022,3,1
2022-03-06 12:25:58,7,6,3,4,17,BTC,-13,3,2022,3,1
2022-03-06 17:00:40,4,2,1,2,5,BTC,-3,1,2022,3,1
2022-03-06 23:05:38,4,7,1,3,11,BTC,-8,6,2022,3,1
2022-03-07 08:15:00,3,1,0,4,0,BTC,4,1,2022,3,1
2022-03-07 09:01:29,30,18,28,12,43,BTC,-31,-10,2022,3,1
2022-03-07 16:39:56,4,4,0,9,1,BTC,8,4,2022,3,1
2022-03-07 19:31:24,5,8,2,15,6,BTC,9,6,2022,3,1
2022-03-07 23:05:27,5,11,0,14,0,BTC,14,11,2022,3,1
2022-03-08 10:53:56,4,4,1,5,7,BTC,-2,3,2022,3,1
2022-03-08 12:20:48,17,16,13,25,26,BTC,-1,3,2022,3,1
2022-03-09 09:47:13,3,2,0,6,0,BTC,6,2,2022,3,1
2022-03-09 09:49:57,15,17,1,23,0,BTC,23,16,2022,3,1
2022-03-09 09:56:46,8,10,0,12,0,BTC,12,10,2022,3,1
2022-03-09 12:33:22,4,2,1,3,4,BTC,-1,1,2022,3,1
2022-03-10 16:17:23,5,7,2,10,2,BTC,8,5,2022,3,1
2022-03-10 20:00:36,12,11,2,17,3,BTC,14,9,2022,3,1
2022-03-11 08:44:18,5,2,1,1,3,BTC,-2,1,2022,3,1
2022-03-11 11:00:01,26,13,22,17,51,BTC,-34,-9,2022,3,1
2022-03-11 11:29:19,3,2,3,1,7,BTC,-6,-1,2022,3,1
2022-03-11 13:29:13,6,4,0,10,0,BTC,10,4,2022,3,1
2022-03-11 13:34:39,3,1,6,2,5,BTC,-3,-5,2022,3,1
2022-03-11 20:57:53,13,10,0,14,0,BTC,14,10,2022,3,1
2022-03-12 19:05:09,3,2,7,3,13,BTC,-10,-5,2022,3,1
2022-03-12 22:00:19,19,33,1,39,1,BTC,38,32,2022,3,1
2022-03-13 08:30:00,9,8,0,15,1,BTC,14,8,2022,3,1
2022-03-13 09:26:44,3,0,1,0,3,BTC,-3,-1,2022,3,1
2022-03-13 11:00:13,9,8,0,15,0,BTC,15,8,2022,3,1
2022-03-13 11:30:52,4,4,0,5,0,BTC,5,4,2022,3,1
2022-03-13 12:19:30,4,3,4,1,4,BTC,-3,-1,2022,3,1
2022-03-13 15:12:54,7,9,1,14,1,BTC,13,8,2022,3,1
2022-03-13 15:46:09,4,2,7,6,3,BTC,3,-5,2022,3,1
2022-03-13 17:46:16,3,1,3,1,7,BTC,-6,-2,2022,3,1
2022-03-13 21:47:56,56,15,15,23,35,BTC,-12,0,2022,3,1
2022-03-14 08:07:32,10,13,3,22,19,BTC,3,10,2022,3,1
2022-03-14 11:32:30,7,2,8,2,11,BTC,-9,-6,2022,3,1
2022-03-14 12:51:55,3,3,3,3,5,BTC,-2,0,2022,3,1
2022-03-14 14:09:36,10,13,2,19,2,BTC,17,11,2022,3,1
2022-03-14 14:36:01,5,4,3,3,8,BTC,-5,1,2022,3,1
2022-03-14 15:25:52,27,42,1,63,5,BTC,58,41,2022,3,1
2022-03-14 15:37:55,21,33,0,54,2,BTC,52,33,2022,3,1
2022-03-14 15:59:09,35,75,1,105,1,BTC,104,74,2022,3,1
2022-03-14 16:05:06,12,27,0,41,0,BTC,41,27,2022,3,1
2022-03-14 17:45:00,4,9,0,12,0,BTC,12,9,2022,3,1
2022-03-14 18:00:44,5,6,1,10,0,BTC,10,5,2022,3,1
2022-03-14 18:03:41,5,6,1,13,2,BTC,11,5,2022,3,1
2022-03-14 19:00:51,4,11,3,19,6,BTC,13,8,2022,3,1
2022-03-14 19:55:40,4,3,0,8,1,BTC,7,3,2022,3,1
2022-03-14 20:00:23,5,4,2,3,8,BTC,-5,2,2022,3,1
2022-03-14 22:12:01,3,6,0,5,0,BTC,5,6,2022,3,1
2022-03-14 22:15:25,6,10,0,14,0,BTC,14,10,2022,3,1
2022-03-14 23:30:08,4,5,1,7,0,BTC,7,4,2022,3,1
2022-03-15 06:07:21,6,10,0,9,2,BTC,7,10,2022,3,1
2022-03-15 10:50:58,5,7,0,6,3,BTC,3,7,2022,3,1
2022-03-15 12:24:04,4,4,2,3,5,BTC,-2,2,2022,3,1
2022-03-15 12:44:11,9,13,0,21,1,BTC,20,13,2022,3,1
2022-03-15 14:15:11,7,8,1,10,0,BTC,10,7,2022,3,1
2022-03-15 14:30:00,8,10,0,12,0,BTC,12,10,2022,3,1
2022-03-15 16:32:07,28,42,0,59,0,BTC,59,42,2022,3,1
2022-03-15 18:00:30,33,51,3,74,2,BTC,72,48,2022,3,1
2022-03-15 20:16:23,4,6,0,6,0,BTC,6,6,2022,3,1
2022-03-15 20:18:30,11,12,0,13,0,BTC,13,12,2022,3,1
2022-03-15 22:01:07,3,2,0,3,0,BTC,3,2,2022,3,1
2022-03-15 23:15:39,4,5,0,5,1,BTC,4,5,2022,3,1
2022-03-16 01:01:16,10,11,0,18,0,BTC,18,11,2022,3,1
2022-03-16 10:16:22,4,6,1,7,2,BTC,5,5,2022,3,1
2022-03-16 11:38:18,4,7,0,11,0,BTC,11,7,2022,3,1
2022-03-16 14:10:55,3,3,1,3,1,BTC,2,2,2022,3,1
2022-03-16 15:42:57,6,5,1,6,1,BTC,5,4,2022,3,1
2022-03-16 18:02:23,28,21,8,37,33,BTC,4,13,2022,3,1
2022-03-16 18:05:23,3,2,0,3,1,BTC,2,2,2022,3,1
2022-03-16 18:12:34,31,41,1,69,0,BTC,69,40,2022,3,1
2022-03-16 18:20:00,3,6,1,6,2,BTC,4,5,2022,3,1
2022-03-16 18:27:53,9,8,2,11,6,BTC,5,6,2022,3,1
2022-03-16 18:43:01,3,4,6,16,16,BTC,0,-2,2022,3,1
2022-03-16 19:31:02,20,31,2,45,1,BTC,44,29,2022,3,1
2022-03-16 20:49:34,4,6,0,5,0,BTC,5,6,2022,3,1
2022-03-16 21:54:17,4,6,1,7,1,BTC,6,5,2022,3,1
2022-03-16 22:01:36,4,3,0,4,0,BTC,4,3,2022,3,1
2022-03-16 23:42:09,3,4,0,11,0,BTC,11,4,2022,3,1
2022-03-17 00:30:00,4,7,0,7,0,BTC,7,7,2022,3,1
2022-03-17 02:31:59,9,11,1,11,1,BTC,10,10,2022,3,1
2022-03-17 03:08:56,7,6,0,7,0,BTC,7,6,2022,3,1
2022-03-17 04:18:15,24,41,2,61,2,BTC,59,39,2022,3,1
2022-03-17 09:30:34,3,2,0,2,1,BTC,1,2,2022,3,1
2022-03-17 10:38:20,9,7,0,9,0,BTC,9,7,2022,3,1
2022-03-17 12:49:04,4,7,0,12,0,BTC,12,7,2022,3,1
2022-03-17 13:19:27,3,9,1,13,2,BTC,11,8,2022,3,1
2022-03-17 15:23:07,4,7,1,5,0,BTC,5,6,2022,3,1
2022-03-17 16:20:52,4,5,0,5,0,BTC,5,5,2022,3,1
2022-03-17 17:12:08,3,3,1,5,0,BTC,5,2,2022,3,1
2022-03-17 18:16:09,9,14,2,19,2,BTC,17,12,2022,3,1
2022-03-18 01:20:00,10,19,0,22,0,BTC,22,19,2022,3,1
2022-03-18 11:54:58,4,2,1,5,1,BTC,4,1,2022,3,1
2022-03-18 14:29:52,6,9,0,12,0,BTC,12,9,2022,3,1
2022-03-18 15:03:14,3,2,0,4,0,BTC,4,2,2022,3,1
2022-03-18 17:00:05,4,6,3,7,3,BTC,4,3,2022,3,1
2022-03-19 00:43:09,5,3,6,4,10,BTC,-6,-3,2022,3,1
2022-03-19 11:08:05,9,11,1,12,1,BTC,11,10,2022,3,1
2022-03-19 12:58:39,3,4,0,6,1,BTC,5,4,2022,3,1
2022-03-19 20:30:11,6,7,0,8,0,BTC,8,7,2022,3,1
2022-03-20 07:04:11,3,4,1,4,0,BTC,4,3,2022,3,1
2022-03-20 09:07:06,3,2,0,2,1,BTC,1,2,2022,3,1
2022-03-20 10:33:27,3,3,0,4,0,BTC,4,3,2022,3,1
2022-03-20 14:30:45,3,5,0,5,0,BTC,5,5,2022,3,1
2022-03-20 16:10:14,9,10,3,15,5,BTC,10,7,2022,3,1
2022-03-20 18:19:40,3,2,0,0,0,BTC,0,2,2022,3,1
2022-03-20 20:00:02,3,12,0,14,0,BTC,14,12,2022,3,1
2022-03-21 08:05:37,9,1,6,1,11,BTC,-10,-5,2022,3,1
2022-03-21 10:40:02,5,6,0,10,1,BTC,9,6,2022,3,1
2022-03-21 11:34:05,38,56,1,83,1,BTC,82,55,2022,3,1
2022-03-21 11:58:21,3,5,0,5,0,BTC,5,5,2022,3,1
2022-03-21 12:09:33,7,6,0,3,3,BTC,0,6,2022,3,1
2022-03-21 12:25:47,6,4,1,9,0,BTC,9,3,2022,3,1
2022-03-21 17:00:37,3,5,0,8,1,BTC,7,5,2022,3,1
2022-03-21 17:49:08,20,23,6,32,5,BTC,27,17,2022,3,1
2022-03-21 19:01:44,3,5,1,6,0,BTC,6,4,2022,3,1
2022-03-21 19:03:01,8,8,0,15,0,BTC,15,8,2022,3,1
2022-03-21 19:21:25,3,5,0,4,0,BTC,4,5,2022,3,1
2022-03-21 22:00:50,17,25,1,38,1,BTC,37,24,2022,3,1
2022-03-21 22:48:00,4,7,1,9,0,BTC,9,6,2022,3,1
2022-03-21 23:15:52,3,7,1,5,0,BTC,5,6,2022,3,1
2022-03-22 01:26:42,3,3,0,5,0,BTC,5,3,2022,3,1
2022-03-22 04:58:43,13,21,1,29,0,BTC,29,20,2022,3,1
2022-03-22 10:57:57,6,8,0,4,0,BTC,4,8,2022,3,1
2022-03-22 11:47:11,7,11,1,8,1,BTC,7,10,2022,3,1
2022-03-22 13:14:49,7,2,6,6,7,BTC,-1,-4,2022,3,1
2022-03-22 17:30:00,13,18,4,26,6,BTC,20,14,2022,3,1
2022-03-22 17:35:48,10,19,1,29,0,BTC,29,18,2022,3,1
2022-03-22 18:56:30,3,4,0,5,0,BTC,5,4,2022,3,1
2022-03-22 19:03:16,3,3,0,4,0,BTC,4,3,2022,3,1
2022-03-22 22:00:27,3,2,1,7,1,BTC,6,1,2022,3,1
2022-03-22 22:50:00,8,13,1,15,2,BTC,13,12,2022,3,1
2022-03-23 01:00:08,21,32,0,44,0,BTC,44,32,2022,3,1
2022-03-23 04:18:08,41,62,2,87,3,BTC,84,60,2022,3,1
2022-03-23 08:26:14,6,0,4,1,8,BTC,-7,-4,2022,3,1
2022-03-23 10:50:02,4,3,2,4,1,BTC,3,1,2022,3,1
2022-03-23 10:56:50,9,7,0,11,0,BTC,11,7,2022,3,1
2022-03-23 11:03:00,4,4,0,5,0,BTC,5,4,2022,3,1
2022-03-23 14:00:40,3,2,0,3,0,BTC,3,2,2022,3,1
2022-03-23 14:02:35,4,6,0,5,0,BTC,5,6,2022,3,1
2022-03-23 15:01:11,3,1,1,3,2,BTC,1,0,2022,3,1
2022-03-23 15:23:01,5,4,0,5,1,BTC,4,4,2022,3,1
2022-03-23 16:44:56,3,0,1,0,2,BTC,-2,-1,2022,3,1
2022-03-23 16:57:21,10,22,0,14,0,BTC,14,22,2022,3,1
2022-03-23 18:41:55,3,4,0,4,0,BTC,4,4,2022,3,1
2022-03-23 18:46:22,24,35,1,64,1,BTC,63,34,2022,3,1
2022-03-24 05:00:56,3,6,0,2,0,BTC,2,6,2022,3,1
2022-03-24 05:55:33,6,2,8,1,15,BTC,-14,-6,2022,3,1
2022-03-24 09:28:46,5,3,5,6,7,BTC,-1,-2,2022,3,1
2022-03-24 09:30:41,3,0,3,1,2,BTC,-1,-3,2022,3,1
2022-03-24 09:33:29,5,7,2,10,0,BTC,10,5,2022,3,1
2022-03-24 09:48:00,4,8,2,10,2,BTC,8,6,2022,3,1
2022-03-24 10:40:59,7,8,1,10,0,BTC,10,7,2022,3,1
2022-03-24 11:45:32,4,7,0,6,0,BTC,6,7,2022,3,1
2022-03-24 12:00:00,6,5,0,6,0,BTC,6,5,2022,3,1
2022-03-24 12:06:40,14,17,3,28,2,BTC,26,14,2022,3,1
2022-03-24 12:25:01,4,8,1,8,1,BTC,7,7,2022,3,1
2022-03-24 14:54:49,5,3,2,4,2,BTC,2,1,2022,3,1
2022-03-24 15:15:00,6,6,0,8,0,BTC,8,6,2022,3,1
2022-03-24 16:01:48,36,43,3,56,9,BTC,47,40,2022,3,1
2022-03-24 16:10:11,4,7,0,6,2,BTC,4,7,2022,3,1
2022-03-24 16:13:01,18,32,1,46,5,BTC,41,31,2022,3,1
2022-03-24 16:19:18,9,10,0,13,1,BTC,12,10,2022,3,1
2022-03-24 16:37:56,3,6,0,6,0,BTC,6,6,2022,3,1
2022-03-24 17:03:31,4,5,0,5,0,BTC,5,5,2022,3,1
2022-03-24 17:14:52,3,10,0,10,2,BTC,8,10,2022,3,1
2022-03-24 17:23:39,6,8,0,8,0,BTC,8,8,2022,3,1
2022-03-24 17:46:49,7,9,0,10,0,BTC,10,9,2022,3,1
2022-03-24 18:07:11,9,10,0,16,0,BTC,16,10,2022,3,1
2022-03-24 18:09:36,3,4,0,4,0,BTC,4,4,2022,3,1
2022-03-24 18:11:18,14,16,0,24,0,BTC,24,16,2022,3,1
2022-03-24 18:41:44,3,4,0,4,0,BTC,4,4,2022,3,1
2022-03-24 19:00:00,5,7,0,8,0,BTC,8,7,2022,3,1
2022-03-24 19:00:04,7,10,0,16,0,BTC,16,10,2022,3,1
2022-03-24 22:05:40,7,9,0,16,0,BTC,16,9,2022,3,1
2022-03-24 22:16:52,10,16,0,21,0,BTC,21,16,2022,3,1
2022-03-25 01:09:41,11,12,0,17,0,BTC,17,12,2022,3,1
2022-03-25 01:21:27,15,21,1,31,2,BTC,29,20,2022,3,1
2022-03-25 08:31:49,7,11,2,24,2,BTC,22,9,2022,3,1
2022-03-25 10:40:22,11,20,1,26,2,BTC,24,19,2022,3,1
2022-03-25 12:22:20,12,30,1,37,0,BTC,37,29,2022,3,1
2022-03-25 12:29:43,6,10,0,16,0,BTC,16,10,2022,3,1
2022-03-25 12:30:00,5,8,0,11,0,BTC,11,8,2022,3,1
2022-03-25 13:17:46,19,30,6,36,10,BTC,26,24,2022,3,1
2022-03-25 13:19:14,3,4,1,6,0,BTC,6,3,2022,3,1
2022-03-25 13:52:24,3,4,0,6,0,BTC,6,4,2022,3,1
2022-03-25 13:57:27,19,29,1,31,1,BTC,30,28,2022,3,1
2022-03-25 14:22:00,3,2,0,3,0,BTC,3,2,2022,3,1
2022-03-25 14:25:52,3,7,0,11,0,BTC,11,7,2022,3,1
2022-03-25 15:05:46,4,1,0,0,1,BTC,-1,1,2022,3,1
2022-03-25 16:08:43,12,2,14,6,21,BTC,-15,-12,2022,3,1
2022-03-25 17:34:44,8,11,0,15,0,BTC,15,11,2022,3,1
2022-03-25 18:39:18,3,6,0,11,1,BTC,10,6,2022,3,1
2022-03-25 21:45:00,4,2,0,4,1,BTC,3,2,2022,3,1
2022-03-26 02:49:56,6,25,9,24,6,BTC,18,16,2022,3,1
2022-03-26 06:36:28,6,7,0,11,1,BTC,10,7,2022,3,1
2022-03-26 08:20:00,3,6,0,6,0,BTC,6,6,2022,3,1
2022-03-26 08:44:46,4,3,0,3,0,BTC,3,3,2022,3,1
2022-03-26 10:04:58,24,39,0,51,2,BTC,49,39,2022,3,1
2022-03-26 12:05:54,21,31,3,37,3,BTC,34,28,2022,3,1
2022-03-26 12:18:17,6,4,0,5,4,BTC,1,4,2022,3,1
2022-03-26 13:10:40,19,20,1,31,1,BTC,30,19,2022,3,1
2022-03-26 14:38:49,4,8,0,8,0,BTC,8,8,2022,3,1
2022-03-26 17:00:41,3,3,0,3,0,BTC,3,3,2022,3,1
2022-03-26 17:08:41,23,29,0,45,1,BTC,44,29,2022,3,1
2022-03-26 17:19:00,25,29,0,49,1,BTC,48,29,2022,3,1
2022-03-26 20:26:42,15,29,1,45,1,BTC,44,28,2022,3,1
2022-03-27 04:48:01,11,23,0,36,0,BTC,36,23,2022,3,1
2022-03-27 06:30:00,3,4,0,3,2,BTC,1,4,2022,3,1
2022-03-27 07:00:32,3,8,0,14,0,BTC,14,8,2022,3,1
2022-03-27 07:04:07,4,6,1,7,2,BTC,5,5,2022,3,1
2022-03-27 08:26:49,5,8,0,19,0,BTC,19,8,2022,3,1
2022-03-27 10:15:25,5,10,0,11,0,BTC,11,10,2022,3,1
2022-03-27 12:40:00,3,6,0,3,0,BTC,3,6,2022,3,1
2022-03-27 13:00:42,4,14,0,12,0,BTC,12,14,2022,3,1
2022-03-27 14:50:00,7,15,1,12,1,BTC,11,14,2022,3,1
2022-03-27 15:09:52,9,13,1,15,0,BTC,15,12,2022,3,1
2022-03-27 15:30:23,58,88,1,114,2,BTC,112,87,2022,3,1
2022-03-27 19:00:00,17,32,4,42,4,BTC,38,28,2022,3,1
2022-03-27 19:12:34,7,9,0,11,1,BTC,10,9,2022,3,1
2022-03-27 20:55:04,12,25,5,41,3,BTC,38,20,2022,3,1
2022-03-27 21:18:02,12,26,0,39,0,BTC,39,26,2022,3,1
2022-03-27 22:20:56,3,8,0,6,0,BTC,6,8,2022,3,1
2022-03-28 03:14:33,5,6,0,13,0,BTC,13,6,2022,3,1
2022-03-28 08:14:23,29,28,7,44,10,BTC,34,21,2022,3,1
2022-03-28 08:34:45,5,5,0,7,0,BTC,7,5,2022,3,1
2022-03-28 08:39:49,3,6,0,10,0,BTC,10,6,2022,3,1
2022-03-28 10:00:17,3,1,0,2,0,BTC,2,1,2022,3,1
2022-03-28 10:26:33,8,7,1,14,2,BTC,12,6,2022,3,1
2022-03-28 10:36:44,6,11,1,11,1,BTC,10,10,2022,3,1
2022-03-28 10:45:46,3,2,2,0,1,BTC,-1,0,2022,3,1
2022-03-28 11:35:00,10,12,3,14,5,BTC,9,9,2022,3,1
2022-03-28 13:16:26,4,4,0,6,2,BTC,4,4,2022,3,1
2022-03-28 13:43:12,5,5,0,5,0,BTC,5,5,2022,3,1
2022-03-28 14:15:59,8,1,5,1,5,BTC,-4,-4,2022,3,1
2022-03-28 14:50:09,13,19,1,22,1,BTC,21,18,2022,3,1
2022-03-28 15:31:27,3,5,0,7,0,BTC,7,5,2022,3,1
2022-03-28 15:44:23,7,8,2,10,3,BTC,7,6,2022,3,1
2022-03-28 15:59:34,10,12,0,16,0,BTC,16,12,2022,3,1
2022-03-28 17:07:36,24,42,1,59,2,BTC,57,41,2022,3,1
2022-03-28 17:13:29,7,7,0,8,0,BTC,8,7,2022,3,1
2022-03-28 20:00:02,3,4,0,3,1,BTC,2,4,2022,3,1
2022-03-28 21:30:53,3,4,0,3,0,BTC,3,4,2022,3,1
2022-03-28 23:10:00,7,15,0,15,0,BTC,15,15,2022,3,1
2022-03-29 00:20:26,3,7,0,6,0,BTC,6,7,2022,3,1
2022-03-29 01:29:00,8,11,1,13,0,BTC,13,10,2022,3,1
2022-03-29 02:05:31,12,20,0,22,0,BTC,22,20,2022,3,1
2022-03-29 05:09:24,8,16,2,29,1,BTC,28,14,2022,3,1
2022-03-29 05:53:01,5,10,0,8,0,BTC,8,10,2022,3,1
2022-03-29 05:53:01,4,9,0,7,0,BTC,7,9,2022,3,1
2022-03-29 06:13:34,9,25,4,27,2,BTC,25,21,2022,3,1
2022-03-29 07:50:46,12,19,1,24,2,BTC,22,18,2022,3,1
2022-03-29 08:33:23,9,22,0,32,0,BTC,32,22,2022,3,1
2022-03-29 09:18:20,5,9,0,10,0,BTC,10,9,2022,3,1
2022-03-29 10:00:00,3,6,0,5,0,BTC,5,6,2022,3,1
2022-03-29 10:10:27,13,24,1,31,1,BTC,30,23,2022,3,1
2022-03-29 11:09:10,12,15,0,24,0,BTC,24,15,2022,3,1
2022-03-29 11:34:18,9,8,12,6,15,BTC,-9,-4,2022,3,1
2022-03-29 14:20:00,14,38,0,35,0,BTC,35,38,2022,3,1
2022-03-29 17:00:39,3,5,0,5,0,BTC,5,5,2022,3,1
2022-03-29 17:00:41,12,20,0,25,0,BTC,25,20,2022,3,1
2022-03-29 20:30:00,10,16,0,21,0,BTC,21,16,2022,3,1
2022-03-29 22:30:00,4,8,0,5,0,BTC,5,8,2022,3,1
2022-03-30 05:04:53,4,9,0,11,0,BTC,11,9,2022,3,1
2022-03-30 10:06:19,3,3,0,3,0,BTC,3,3,2022,3,1
2022-03-30 10:33:16,10,16,1,22,0,BTC,22,15,2022,3,1
2022-03-30 10:41:57,7,10,0,8,1,BTC,7,10,2022,3,1
2022-03-30 10:57:59,5,8,1,8,0,BTC,8,7,2022,3,1
2022-03-30 13:29:38,3,3,4,1,3,BTC,-2,-1,2022,3,1
2022-03-30 14:26:35,4,6,0,6,1,BTC,5,6,2022,3,1
2022-03-30 14:47:01,8,11,1,14,1,BTC,13,10,2022,3,1
2022-03-30 16:21:40,8,11,1,12,1,BTC,11,10,2022,3,1
2022-03-30 17:27:04,4,1,3,1,2,BTC,-1,-2,2022,3,1
2022-03-30 20:39:06,3,3,0,3,0,BTC,3,3,2022,3,1
2022-03-30 21:31:17,4,5,0,4,0,BTC,4,5,2022,3,1
2022-03-30 22:01:27,5,15,0,16,0,BTC,16,15,2022,3,1
2022-03-31 09:28:01,4,5,1,6,0,BTC,6,4,2022,3,1
2022-03-31 09:36:15,17,11,23,3,44,BTC,-41,-12,2022,3,1
2022-03-31 11:47:00,3,0,0,2,0,BTC,2,0,2022,3,1
2022-03-31 12:02:27,8,15,0,25,0,BTC,25,15,2022,3,1
2022-03-31 12:37:28,8,27,3,36,2,BTC,34,24,2022,3,1
2022-03-31 13:30:00,8,9,0,14,0,BTC,14,9,2022,3,1
2022-03-31 18:30:08,3,3,0,1,0,BTC,1,3,2022,3,1
2022-03-31 19:01:29,3,5,0,6,0,BTC,6,5,2022,3,1
2022-03-31 19:48:20,6,3,10,1,6,BTC,-5,-7,2022,3,1
2022-03-31 21:03:09,15,27,3,36,3,BTC,33,24,2022,3,1
2022-03-31 23:15:43,28,5,20,5,35,BTC,-30,-15,2022,3,1
2022-04-01 00:04:43,3,3,1,3,0,BTC,3,2,2022,4,2
2022-04-01 01:20:17,13,2,10,2,20,BTC,-18,-8,2022,4,2
2022-04-01 09:36:23,3,5,10,6,6,BTC,0,-5,2022,4,2
2022-04-01 09:37:49,8,9,0,10,1,BTC,9,9,2022,4,2
2022-04-01 11:51:15,5,6,3,6,5,BTC,1,3,2022,4,2
2022-04-01 12:41:57,3,2,3,5,3,BTC,2,-1,2022,4,2
2022-04-01 13:06:02,7,22,0,46,0,BTC,46,22,2022,4,2
2022-04-01 13:38:17,4,0,3,1,3,BTC,-2,-3,2022,4,2
2022-04-01 13:41:00,6,7,0,6,0,BTC,6,7,2022,4,2
2022-04-01 14:30:21,3,3,0,5,0,BTC,5,3,2022,4,2
2022-04-01 14:32:56,5,8,1,8,1,BTC,7,7,2022,4,2
2022-04-01 14:48:00,5,5,0,14,0,BTC,14,5,2022,4,2
2022-04-01 17:13:49,27,50,1,57,2,BTC,55,49,2022,4,2
2022-04-01 17:26:23,5,10,0,9,0,BTC,9,10,2022,4,2
2022-04-01 18:11:27,11,15,0,17,0,BTC,17,15,2022,4,2
2022-04-01 18:35:11,3,6,0,8,1,BTC,7,6,2022,4,2
2022-04-01 20:49:02,9,9,12,8,13,BTC,-5,-3,2022,4,2
2022-04-01 23:00:01,5,7,0,11,0,BTC,11,7,2022,4,2
2022-04-02 00:00:03,6,13,3,20,3,BTC,17,10,2022,4,2
2022-04-02 04:04:36,27,37,0,54,2,BTC,52,37,2022,4,2
2022-04-02 06:08:33,20,34,2,44,2,BTC,42,32,2022,4,2
2022-04-02 12:49:19,23,32,1,51,1,BTC,50,31,2022,4,2
2022-04-02 17:01:19,9,10,0,15,0,BTC,15,10,2022,4,2
2022-04-02 19:52:21,7,10,0,9,0,BTC,9,10,2022,4,2
2022-04-02 20:00:09,6,11,2,14,3,BTC,11,9,2022,4,2
2022-04-02 20:59:19,9,15,0,18,2,BTC,16,15,2022,4,2
2022-04-02 21:00:08,13,7,17,8,17,BTC,-9,-10,2022,4,2
2022-04-03 01:30:40,3,5,0,4,0,BTC,4,5,2022,4,2
2022-04-03 10:15:00,5,6,0,8,0,BTC,8,6,2022,4,2
2022-04-03 10:28:13,6,3,2,1,0,BTC,1,1,2022,4,2
2022-04-03 14:18:50,5,5,0,6,1,BTC,5,5,2022,4,2
2022-04-03 20:00:49,3,4,0,6,0,BTC,6,4,2022,4,2
2022-04-03 21:18:10,13,22,0,35,2,BTC,33,22,2022,4,2
2022-04-04 06:45:19,5,10,0,15,0,BTC,15,10,2022,4,2
2022-04-04 13:00:00,18,35,1,41,3,BTC,38,34,2022,4,2
2022-04-04 13:21:15,12,16,4,22,20,BTC,2,12,2022,4,2
2022-04-04 14:34:12,5,5,0,7,0,BTC,7,5,2022,4,2
2022-04-04 18:58:02,9,25,6,30,8,BTC,22,19,2022,4,2
2022-04-04 20:39:18,5,11,0,15,0,BTC,15,11,2022,4,2
2022-04-04 22:00:46,8,10,0,10,0,BTC,10,10,2022,4,2
2022-04-04 22:01:28,3,6,0,7,0,BTC,7,6,2022,4,2
2022-04-04 22:40:15,21,32,0,48,0,BTC,48,32,2022,4,2
2022-04-04 23:00:10,7,13,1,18,0,BTC,18,12,2022,4,2
2022-04-05 03:02:00,3,8,1,7,1,BTC,6,7,2022,4,2
2022-04-05 03:45:42,26,30,8,48,5,BTC,43,22,2022,4,2
2022-04-05 06:46:41,3,5,0,4,0,BTC,4,5,2022,4,2
2022-04-05 08:33:35,8,3,7,0,5,BTC,-5,-4,2022,4,2
2022-04-05 12:12:31,27,42,0,56,2,BTC,54,42,2022,4,2
2022-04-05 13:02:19,7,8,2,5,3,BTC,2,6,2022,4,2
2022-04-05 13:10:08,6,14,0,17,0,BTC,17,14,2022,4,2
2022-04-05 13:30:35,4,5,1,8,1,BTC,7,4,2022,4,2
2022-04-05 14:01:00,7,10,0,11,1,BTC,10,10,2022,4,2
2022-04-05 15:06:52,6,12,1,17,0,BTC,17,11,2022,4,2
2022-04-05 17:16:54,5,12,0,13,0,BTC,13,12,2022,4,2
2022-04-05 17:41:39,5,6,0,6,1,BTC,5,6,2022,4,2
2022-04-05 18:01:54,7,9,0,18,0,BTC,18,9,2022,4,2
2022-04-05 19:03:58,3,4,0,6,0,BTC,6,4,2022,4,2
2022-04-05 20:00:00,5,7,0,8,2,BTC,6,7,2022,4,2
2022-04-05 20:08:25,12,12,0,19,0,BTC,19,12,2022,4,2
2022-04-06 03:13:19,6,3,1,4,1,BTC,3,2,2022,4,2
2022-04-06 10:30:00,4,0,4,7,3,BTC,4,-4,2022,4,2
2022-04-06 11:30:00,8,6,2,11,3,BTC,8,4,2022,4,2
2022-04-06 12:50:04,7,5,0,6,6,BTC,0,5,2022,4,2
2022-04-06 13:29:32,27,50,2,60,3,BTC,57,48,2022,4,2
2022-04-06 13:46:00,3,4,0,5,0,BTC,5,4,2022,4,2
2022-04-06 14:03:09,7,10,0,13,0,BTC,13,10,2022,4,2
2022-04-06 16:37:33,4,4,2,8,6,BTC,2,2,2022,4,2
2022-04-06 20:30:35,10,10,1,20,1,BTC,19,9,2022,4,2
2022-04-06 21:25:26,4,4,0,8,1,BTC,7,4,2022,4,2
2022-04-06 21:30:28,4,5,2,10,3,BTC,7,3,2022,4,2
2022-04-06 22:20:23,3,5,0,6,1,BTC,5,5,2022,4,2
2022-04-07 00:06:57,3,3,0,4,0,BTC,4,3,2022,4,2
2022-04-07 01:30:07,3,5,4,5,2,BTC,3,1,2022,4,2
2022-04-07 07:04:29,34,60,1,84,3,BTC,81,59,2022,4,2
2022-04-07 10:08:00,19,30,0,47,0,BTC,47,30,2022,4,2
2022-04-07 11:15:39,5,9,0,8,0,BTC,8,9,2022,4,2
2022-04-07 13:04:12,8,11,4,8,5,BTC,3,7,2022,4,2
2022-04-07 13:16:50,6,5,0,4,0,BTC,4,5,2022,4,2
2022-04-07 14:24:56,3,7,0,8,0,BTC,8,7,2022,4,2
2022-04-07 14:47:47,3,3,0,3,0,BTC,3,3,2022,4,2
2022-04-07 14:56:41,29,53,0,73,0,BTC,73,53,2022,4,2
2022-04-07 17:27:12,3,2,0,4,0,BTC,4,2,2022,4,2
2022-04-07 17:57:59,12,24,9,22,10,BTC,12,15,2022,4,2
2022-04-07 18:12:11,4,5,0,3,0,BTC,3,5,2022,4,2
2022-04-07 19:04:59,3,4,0,3,0,BTC,3,4,2022,4,2
2022-04-07 19:19:59,3,2,0,4,0,BTC,4,2,2022,4,2
2022-04-07 19:20:36,32,50,0,70,0,BTC,70,50,2022,4,2
2022-04-07 20:14:39,5,5,0,2,0,BTC,2,5,2022,4,2
2022-04-07 20:17:14,3,5,0,4,0,BTC,4,5,2022,4,2
2022-04-07 21:19:33,3,2,1,4,0,BTC,4,1,2022,4,2
2022-04-07 22:11:24,3,3,1,5,1,BTC,4,2,2022,4,2
2022-04-07 23:02:23,3,7,0,5,0,BTC,5,7,2022,4,2
2022-04-08 01:15:09,73,110,3,166,4,BTC,162,107,2022,4,2
2022-04-08 04:21:36,3,4,1,5,1,BTC,4,3,2022,4,2
2022-04-08 05:02:07,4,11,0,17,1,BTC,16,11,2022,4,2
2022-04-08 06:29:28,4,9,0,11,0,BTC,11,9,2022,4,2
2022-04-08 07:04:11,4,4,0,6,0,BTC,6,4,2022,4,2
2022-04-08 07:13:42,3,4,0,5,0,BTC,5,4,2022,4,2
2022-04-08 08:05:02,3,7,0,4,0,BTC,4,7,2022,4,2
2022-04-08 08:20:03,7,7,0,15,2,BTC,13,7,2022,4,2
2022-04-08 08:47:50,11,8,4,10,5,BTC,5,4,2022,4,2
2022-04-08 08:49:00,16,21,4,26,19,BTC,7,17,2022,4,2
2022-04-08 09:40:50,6,10,2,15,2,BTC,13,8,2022,4,2
2022-04-08 10:00:52,4,12,0,22,0,BTC,22,12,2022,4,2
2022-04-08 11:30:00,5,11,0,15,0,BTC,15,11,2022,4,2
2022-04-08 11:31:55,11,24,1,26,1,BTC,25,23,2022,4,2
2022-04-08 11:52:21,3,5,0,8,0,BTC,8,5,2022,4,2
2022-04-08 13:44:04,3,7,0,9,1,BTC,8,7,2022,4,2
2022-04-08 14:10:30,9,13,3,19,7,BTC,12,10,2022,4,2
2022-04-08 14:30:30,5,6,0,6,0,BTC,6,6,2022,4,2
2022-04-08 15:02:11,9,14,0,21,0,BTC,21,14,2022,4,2
2022-04-08 15:07:51,20,29,3,39,6,BTC,33,26,2022,4,2
2022-04-08 15:30:02,3,5,0,6,0,BTC,6,5,2022,4,2
2022-04-08 15:49:27,13,25,1,31,1,BTC,30,24,2022,4,2
2022-04-08 15:56:05,3,5,0,2,1,BTC,1,5,2022,4,2
2022-04-08 16:33:24,3,4,0,4,0,BTC,4,4,2022,4,2
2022-04-08 17:50:05,9,11,0,18,0,BTC,18,11,2022,4,2
2022-04-08 17:54:00,3,3,0,4,0,BTC,4,3,2022,4,2
2022-04-08 18:47:11,7,9,0,14,0,BTC,14,9,2022,4,2
2022-04-08 21:27:10,3,7,1,15,0,BTC,15,6,2022,4,2
2022-04-09 01:30:44,8,18,0,28,4,BTC,24,18,2022,4,2
2022-04-09 09:05:03,7,7,4,3,4,BTC,-1,3,2022,4,2
2022-04-09 13:11:07,3,1,3,4,5,BTC,-1,-2,2022,4,2
2022-04-09 14:56:37,6,9,1,7,1,BTC,6,8,2022,4,2
2022-04-09 17:07:48,26,28,1,40,0,BTC,40,27,2022,4,2
2022-04-09 20:30:00,12,16,0,22,0,BTC,22,16,2022,4,2
2022-04-10 02:30:02,12,17,0,20,0,BTC,20,17,2022,4,2
2022-04-10 06:21:26,3,10,2,20,4,BTC,16,8,2022,4,2
2022-04-10 07:04:24,11,11,0,21,1,BTC,20,11,2022,4,2
2022-04-10 10:43:27,12,18,7,22,7,BTC,15,11,2022,4,2
2022-04-10 12:21:19,18,28,2,35,2,BTC,33,26,2022,4,2
2022-04-10 15:28:31,6,9,1,14,0,BTC,14,8,2022,4,2
2022-04-10 18:21:26,7,14,0,17,0,BTC,17,14,2022,4,2
2022-04-11 04:03:36,5,11,4,14,5,BTC,9,7,2022,4,2
2022-04-11 07:30:29,3,1,5,1,6,BTC,-5,-4,2022,4,2
2022-04-11 08:58:34,5,4,3,6,5,BTC,1,1,2022,4,2
2022-04-11 11:17:04,6,10,3,11,15,BTC,-4,7,2022,4,2
2022-04-11 11:51:36,6,8,2,9,0,BTC,9,6,2022,4,2
2022-04-11 12:02:50,6,11,0,19,0,BTC,19,11,2022,4,2
2022-04-11 13:13:49,12,17,1,24,0,BTC,24,16,2022,4,2
2022-04-11 13:34:17,14,12,9,10,18,BTC,-8,3,2022,4,2
2022-04-11 15:00:07,30,31,1,40,5,BTC,35,30,2022,4,2
2022-04-11 15:08:15,13,31,0,34,4,BTC,30,31,2022,4,2
2022-04-11 15:33:33,3,5,1,9,6,BTC,3,4,2022,4,2
2022-04-11 22:38:45,22,32,0,49,1,BTC,48,32,2022,4,2
2022-04-12 01:25:35,5,4,1,6,7,BTC,-1,3,2022,4,2
2022-04-12 09:37:06,11,14,0,21,3,BTC,18,14,2022,4,2
2022-04-12 10:50:38,5,7,0,10,0,BTC,10,7,2022,4,2
2022-04-12 12:37:00,3,1,0,1,3,BTC,-2,1,2022,4,2
2022-04-12 14:45:00,3,6,0,5,0,BTC,5,6,2022,4,2
2022-04-12 18:05:21,4,5,2,5,5,BTC,0,3,2022,4,2
2022-04-13 09:08:23,19,30,2,31,1,BTC,30,28,2022,4,2
2022-04-13 09:36:06,4,8,0,7,0,BTC,7,8,2022,4,2
2022-04-13 13:44:33,4,3,2,0,7,BTC,-7,1,2022,4,2
2022-04-13 15:31:06,3,0,0,1,3,BTC,-2,0,2022,4,2
2022-04-13 15:40:42,3,3,0,9,2,BTC,7,3,2022,4,2
2022-04-13 15:45:00,19,38,0,45,1,BTC,44,38,2022,4,2
2022-04-14 01:00:00,5,5,1,10,1,BTC,9,4,2022,4,2
2022-04-14 07:04:19,27,45,0,73,3,BTC,70,45,2022,4,2
2022-04-14 11:18:30,7,3,13,3,11,BTC,-8,-10,2022,4,2
2022-04-14 11:38:36,6,7,0,10,0,BTC,10,7,2022,4,2
2022-04-14 11:49:26,3,4,0,5,0,BTC,5,4,2022,4,2
2022-04-14 12:00:04,15,28,0,34,0,BTC,34,28,2022,4,2
2022-04-14 13:15:20,5,8,1,6,1,BTC,5,7,2022,4,2
2022-04-14 14:23:39,9,8,1,14,1,BTC,13,7,2022,4,2
2022-04-14 22:30:17,8,11,0,12,1,BTC,11,11,2022,4,2
2022-04-15 00:59:23,6,7,0,11,2,BTC,9,7,2022,4,2
2022-04-15 09:08:59,11,25,1,32,1,BTC,31,24,2022,4,2
2022-04-15 09:14:16,5,4,5,3,2,BTC,1,-1,2022,4,2
2022-04-15 12:21:57,4,4,1,4,1,BTC,3,3,2022,4,2
2022-04-15 13:03:58,6,1,1,1,11,BTC,-10,0,2022,4,2
2022-04-15 22:00:15,8,13,0,20,0,BTC,20,13,2022,4,2
2022-04-16 00:33:30,4,6,0,6,0,BTC,6,6,2022,4,2
2022-04-16 01:21:19,3,1,2,2,2,BTC,0,-1,2022,4,2
2022-04-16 10:38:25,4,6,0,4,0,BTC,4,6,2022,4,2
2022-04-16 11:47:27,7,3,0,0,6,BTC,-6,3,2022,4,2
2022-04-16 12:53:52,4,6,0,11,0,BTC,11,6,2022,4,2
2022-04-16 14:30:14,7,23,0,41,2,BTC,39,23,2022,4,2
2022-04-16 16:59:02,51,63,4,89,3,BTC,86,59,2022,4,2
2022-04-16 18:00:00,3,7,0,8,0,BTC,8,7,2022,4,2
2022-04-16 20:19:02,5,3,2,6,2,BTC,4,1,2022,4,2
2022-04-17 06:10:49,3,2,0,1,0,BTC,1,2,2022,4,2
2022-04-17 09:45:01,3,4,0,4,0,BTC,4,4,2022,4,2
2022-04-17 11:38:51,13,20,4,23,4,BTC,19,16,2022,4,2
2022-04-17 12:15:18,4,6,0,6,0,BTC,6,6,2022,4,2
2022-04-17 16:21:33,18,37,1,58,0,BTC,58,36,2022,4,2
2022-04-17 17:25:03,5,4,0,3,0,BTC,3,4,2022,4,2
2022-04-17 18:42:47,6,11,0,15,1,BTC,14,11,2022,4,2
2022-04-17 20:00:05,8,6,2,5,5,BTC,0,4,2022,4,2
2022-04-18 09:54:54,4,4,0,6,6,BTC,0,4,2022,4,2
2022-04-18 11:00:16,15,12,9,8,20,BTC,-12,3,2022,4,2
2022-04-18 11:45:19,6,8,0,12,1,BTC,11,8,2022,4,2
2022-04-18 12:09:17,6,16,3,24,14,BTC,10,13,2022,4,2
2022-04-18 15:33:05,22,31,2,44,1,BTC,43,29,2022,4,2
2022-04-18 15:37:43,3,1,0,6,0,BTC,6,1,2022,4,2
2022-04-18 16:55:40,3,4,2,5,2,BTC,3,2,2022,4,2
2022-04-18 19:00:22,3,6,0,5,0,BTC,5,6,2022,4,2
2022-04-18 19:30:41,3,2,1,3,1,BTC,2,1,2022,4,2
2022-04-19 09:58:05,3,5,0,7,0,BTC,7,5,2022,4,2
2022-04-19 11:02:54,14,20,0,31,0,BTC,31,20,2022,4,2
2022-04-19 11:27:36,6,7,1,6,0,BTC,6,6,2022,4,2
2022-04-19 11:57:58,3,4,0,6,0,BTC,6,4,2022,4,2
2022-04-19 14:31:24,6,8,1,6,0,BTC,6,7,2022,4,2
2022-04-19 16:19:49,4,3,0,4,0,BTC,4,3,2022,4,2
2022-04-19 20:00:47,5,8,0,12,0,BTC,12,8,2022,4,2
2022-04-20 00:30:00,4,4,0,4,0,BTC,4,4,2022,4,2
2022-04-20 01:57:06,4,10,0,15,0,BTC,15,10,2022,4,2
2022-04-20 03:40:54,12,14,0,24,0,BTC,24,14,2022,4,2
2022-04-20 05:31:03,28,55,0,76,1,BTC,75,55,2022,4,2
2022-04-20 10:15:19,3,5,4,3,3,BTC,0,1,2022,4,2
2022-04-20 12:07:35,8,10,1,11,1,BTC,10,9,2022,4,2
2022-04-20 12:09:22,19,26,1,38,2,BTC,36,25,2022,4,2
2022-04-20 14:31:48,18,24,4,27,3,BTC,24,20,2022,4,2
2022-04-20 16:00:00,21,38,1,47,1,BTC,46,37,2022,4,2
2022-04-20 16:48:28,4,4,5,11,2,BTC,9,-1,2022,4,2
2022-04-20 19:37:48,8,11,0,15,0,BTC,15,11,2022,4,2
2022-04-21 07:04:10,3,8,0,9,1,BTC,8,8,2022,4,2
2022-04-21 09:00:09,4,2,1,2,1,BTC,1,1,2022,4,2
2022-04-21 09:07:04,5,4,1,5,0,BTC,5,3,2022,4,2
2022-04-21 10:27:08,10,10,1,14,0,BTC,14,9,2022,4,2
2022-04-21 12:13:49,4,4,0,6,0,BTC,6,4,2022,4,2
2022-04-21 13:01:35,3,1,0,3,2,BTC,1,1,2022,4,2
2022-04-21 13:28:33,16,28,1,30,2,BTC,28,27,2022,4,2
2022-04-21 13:33:35,5,5,4,5,3,BTC,2,1,2022,4,2
2022-04-21 14:13:27,4,3,7,5,3,BTC,2,-4,2022,4,2
2022-04-21 16:12:47,7,4,5,6,4,BTC,2,-1,2022,4,2
2022-04-21 22:05:37,5,6,0,9,0,BTC,9,6,2022,4,2
2022-04-21 23:05:30,7,7,1,10,0,BTC,10,6,2022,4,2
2022-04-22 02:14:49,4,8,0,10,0,BTC,10,8,2022,4,2
2022-04-22 09:14:53,20,33,0,45,0,BTC,45,33,2022,4,2
2022-04-22 12:59:53,5,3,1,5,0,BTC,5,2,2022,4,2
2022-04-22 14:56:53,5,7,0,8,0,BTC,8,7,2022,4,2
2022-04-22 17:53:03,4,1,10,2,14,BTC,-12,-9,2022,4,2
2022-04-22 18:58:18,6,3,5,11,3,BTC,8,-2,2022,4,2
2022-04-22 21:25:56,10,7,18,19,23,BTC,-4,-11,2022,4,2
2022-04-22 23:00:21,3,4,0,2,1,BTC,1,4,2022,4,2
2022-04-23 12:12:07,9,5,3,5,0,BTC,5,2,2022,4,2
2022-04-23 15:07:40,8,19,1,18,0,BTC,18,18,2022,4,2
2022-04-23 16:18:06,14,6,29,11,34,BTC,-23,-23,2022,4,2
2022-04-23 22:00:49,3,3,0,7,0,BTC,7,3,2022,4,2
2022-04-24 06:43:05,5,9,5,10,2,BTC,8,4,2022,4,2
2022-04-24 06:48:35,3,5,0,6,1,BTC,5,5,2022,4,2
2022-04-24 14:30:26,9,15,6,16,6,BTC,10,9,2022,4,2
2022-04-24 20:48:33,8,11,0,19,2,BTC,17,11,2022,4,2
2022-04-24 21:15:02,19,15,2,26,2,BTC,24,13,2022,4,2
2022-04-25 06:07:35,21,35,2,55,2,BTC,53,33,2022,4,2
2022-04-25 06:45:49,4,2,3,2,4,BTC,-2,-1,2022,4,2
2022-04-25 08:15:00,9,10,0,13,0,BTC,13,10,2022,4,2
2022-04-25 08:50:39,3,6,0,9,0,BTC,9,6,2022,4,2
2022-04-25 09:15:33,3,7,0,13,0,BTC,13,7,2022,4,2
2022-04-25 09:50:48,8,11,0,17,0,BTC,17,11,2022,4,2
2022-04-25 09:55:31,20,28,0,41,1,BTC,40,28,2022,4,2
2022-04-25 12:12:47,5,1,6,5,4,BTC,1,-5,2022,4,2
2022-04-25 13:33:55,3,2,0,1,2,BTC,-1,2,2022,4,2
2022-04-25 14:17:11,6,7,1,8,1,BTC,7,6,2022,4,2
2022-04-25 19:11:51,4,8,0,11,2,BTC,9,8,2022,4,2
2022-04-25 21:27:54,23,42,3,47,5,BTC,42,39,2022,4,2
2022-04-25 21:41:51,3,4,0,3,1,BTC,2,4,2022,4,2
2022-04-25 22:05:46,11,12,0,18,0,BTC,18,12,2022,4,2
2022-04-26 05:10:19,29,35,0,57,0,BTC,57,35,2022,4,2
2022-04-26 06:45:11,3,6,0,9,1,BTC,8,6,2022,4,2
2022-04-26 09:25:38,5,6,0,7,1,BTC,6,6,2022,4,2
2022-04-26 09:34:22,8,9,0,14,0,BTC,14,9,2022,4,2
2022-04-26 10:48:00,4,11,0,9,1,BTC,8,11,2022,4,2
2022-04-26 11:43:11,5,7,0,7,1,BTC,6,7,2022,4,2
2022-04-26 11:45:27,4,6,0,6,0,BTC,6,6,2022,4,2
2022-04-26 11:57:08,21,26,0,35,0,BTC,35,26,2022,4,2
2022-04-26 13:58:24,6,10,0,10,0,BTC,10,10,2022,4,2
2022-04-26 14:21:31,4,4,1,3,1,BTC,2,3,2022,4,2
2022-04-26 15:07:03,3,4,0,5,0,BTC,5,4,2022,4,2
2022-04-26 16:10:24,6,3,0,1,1,BTC,0,3,2022,4,2
2022-04-26 17:00:36,4,7,2,7,4,BTC,3,5,2022,4,2
2022-04-26 17:15:00,5,6,0,8,1,BTC,7,6,2022,4,2
2022-04-26 18:00:50,4,4,0,4,2,BTC,2,4,2022,4,2
2022-04-26 18:50:55,16,26,0,32,0,BTC,32,26,2022,4,2
2022-04-26 19:00:13,3,3,1,3,2,BTC,1,2,2022,4,2
2022-04-27 04:12:52,9,11,0,12,1,BTC,11,11,2022,4,2
2022-04-27 04:37:04,13,18,0,22,0,BTC,22,18,2022,4,2
2022-04-27 06:36:55,6,7,0,10,0,BTC,10,7,2022,4,2
2022-04-27 09:11:04,8,12,0,11,0,BTC,11,12,2022,4,2
2022-04-27 10:19:20,3,4,0,6,0,BTC,6,4,2022,4,2
2022-04-27 10:47:14,3,4,0,5,1,BTC,4,4,2022,4,2
2022-04-27 11:01:26,3,3,0,6,1,BTC,5,3,2022,4,2
2022-04-27 11:28:41,4,4,3,1,6,BTC,-5,1,2022,4,2
2022-04-27 12:18:41,5,6,0,13,1,BTC,12,6,2022,4,2
2022-04-27 13:12:26,29,28,0,56,1,BTC,55,28,2022,4,2
2022-04-27 15:37:58,6,5,1,3,2,BTC,1,4,2022,4,2
2022-04-27 16:06:24,5,10,0,12,1,BTC,11,10,2022,4,2
2022-04-27 18:27:59,5,10,0,12,0,BTC,12,10,2022,4,2
2022-04-27 18:50:58,8,6,0,12,0,BTC,12,6,2022,4,2
2022-04-27 18:58:58,16,13,0,23,1,BTC,22,13,2022,4,2
2022-04-27 23:45:52,6,6,0,9,1,BTC,8,6,2022,4,2
2022-04-28 01:00:10,6,10,0,13,0,BTC,13,10,2022,4,2
2022-04-28 01:12:40,5,3,10,2,15,BTC,-13,-7,2022,4,2
2022-04-28 01:16:26,17,22,0,28,1,BTC,27,22,2022,4,2
2022-04-28 08:00:33,3,2,0,3,2,BTC,1,2,2022,4,2
2022-04-28 08:37:20,7,6,1,8,2,BTC,6,5,2022,4,2
2022-04-28 10:38:46,11,15,1,13,2,BTC,11,14,2022,4,2
2022-04-28 11:58:10,3,8,0,9,1,BTC,8,8,2022,4,2
2022-04-28 15:12:38,12,16,1,14,1,BTC,13,15,2022,4,2
2022-04-28 15:50:19,3,9,3,4,4,BTC,0,6,2022,4,2
2022-04-28 16:26:17,4,4,0,4,1,BTC,3,4,2022,4,2
2022-04-28 17:09:14,5,3,0,3,1,BTC,2,3,2022,4,2
2022-04-28 18:47:48,3,4,0,8,1,BTC,7,4,2022,4,2
2022-04-28 21:22:07,6,11,0,15,0,BTC,15,11,2022,4,2
2022-04-28 23:45:42,12,16,0,18,1,BTC,17,16,2022,4,2
2022-04-29 07:57:19,4,6,0,10,1,BTC,9,6,2022,4,2
2022-04-29 08:26:30,4,3,5,3,2,BTC,1,-2,2022,4,2
2022-04-29 15:02:03,7,7,0,8,2,BTC,6,7,2022,4,2
2022-04-29 15:15:20,5,1,5,5,3,BTC,2,-4,2022,4,2
2022-04-29 17:00:55,3,4,1,3,6,BTC,-3,3,2022,4,2
2022-04-29 20:36:30,3,2,0,2,3,BTC,-1,2,2022,4,2
2022-04-30 12:13:46,6,11,1,8,3,BTC,5,10,2022,4,2
2022-04-30 14:30:27,8,10,0,12,1,BTC,11,10,2022,4,2
2022-04-30 15:00:00,4,4,0,6,1,BTC,5,4,2022,4,2
2022-04-30 16:18:33,5,6,1,10,2,BTC,8,5,2022,4,2
2022-04-30 19:32:07,17,36,0,41,2,BTC,39,36,2022,4,2
2022-04-30 20:00:10,14,18,0,26,1,BTC,25,18,2022,4,2
2022-05-01 02:50:00,6,8,0,15,0,BTC,15,8,2022,5,2
2022-05-01 14:33:43,9,12,0,16,1,BTC,15,12,2022,5,2
2022-05-01 16:11:02,10,21,1,27,1,BTC,26,20,2022,5,2
2022-05-01 16:38:56,17,30,29,49,23,BTC,26,1,2022,5,2
2022-05-01 18:55:36,4,8,0,11,1,BTC,10,8,2022,5,2
2022-05-01 19:12:02,6,5,2,8,7,BTC,1,3,2022,5,2
2022-05-01 19:55:00,3,0,1,1,4,BTC,-3,-1,2022,5,2
2022-05-01 20:00:02,4,7,0,7,0,BTC,7,7,2022,5,2
2022-05-01 22:40:11,25,44,1,61,1,BTC,60,43,2022,5,2
2022-05-02 02:00:16,3,3,0,3,0,BTC,3,3,2022,5,2
2022-05-02 09:05:25,5,7,0,3,1,BTC,2,7,2022,5,2
2022-05-02 11:36:06,10,14,3,16,1,BTC,15,11,2022,5,2
2022-05-02 12:47:39,4,4,0,5,1,BTC,4,4,2022,5,2
2022-05-02 12:52:51,7,9,0,7,1,BTC,6,9,2022,5,2
2022-05-02 13:13:15,8,11,2,12,3,BTC,9,9,2022,5,2
2022-05-02 16:09:46,3,4,1,3,2,BTC,1,3,2022,5,2
2022-05-02 17:00:04,4,6,0,6,1,BTC,5,6,2022,5,2
2022-05-02 17:50:00,4,4,0,4,0,BTC,4,4,2022,5,2
2022-05-02 18:17:32,28,54,0,58,4,BTC,54,54,2022,5,2
2022-05-02 18:57:33,3,2,3,4,6,BTC,-2,-1,2022,5,2
2022-05-02 20:14:29,4,6,0,7,1,BTC,6,6,2022,5,2
2022-05-03 00:00:00,8,15,0,17,1,BTC,16,15,2022,5,2
2022-05-03 07:30:55,4,5,1,8,1,BTC,7,4,2022,5,2
2022-05-03 08:10:49,4,9,0,9,1,BTC,8,9,2022,5,2
2022-05-03 09:28:35,9,9,0,10,2,BTC,8,9,2022,5,2
2022-05-03 13:28:05,11,18,0,24,2,BTC,22,18,2022,5,2
2022-05-03 13:44:11,3,6,0,5,1,BTC,4,6,2022,5,2
2022-05-03 14:09:56,4,2,0,4,1,BTC,3,2,2022,5,2
2022-05-03 14:17:32,3,2,1,2,1,BTC,1,1,2022,5,2
2022-05-03 16:43:02,14,15,0,23,0,BTC,23,15,2022,5,2
2022-05-03 17:00:15,3,12,3,15,6,BTC,9,9,2022,5,2
2022-05-03 17:01:39,5,9,0,11,1,BTC,10,9,2022,5,2
2022-05-03 22:05:40,6,4,2,4,1,BTC,3,2,2022,5,2
2022-05-03 22:51:26,3,1,1,2,4,BTC,-2,0,2022,5,2
2022-05-04 03:31:47,3,4,0,3,2,BTC,1,4,2022,5,2
2022-05-04 03:49:17,3,8,1,7,4,BTC,3,7,2022,5,2
2022-05-04 09:40:07,23,36,5,37,8,BTC,29,31,2022,5,2
2022-05-04 10:15:00,4,4,1,4,2,BTC,2,3,2022,5,2
2022-05-04 10:46:11,7,8,0,10,1,BTC,9,8,2022,5,2
2022-05-04 15:47:55,14,22,1,28,10,BTC,18,21,2022,5,2
2022-05-04 17:49:52,31,46,1,53,4,BTC,49,45,2022,5,2
2022-05-04 20:05:48,16,25,0,38,1,BTC,37,25,2022,5,2
2022-05-04 21:10:36,3,4,0,9,0,BTC,9,4,2022,5,2
2022-05-05 00:59:45,7,17,0,21,2,BTC,19,17,2022,5,2
2022-05-05 01:20:48,3,6,0,14,2,BTC,12,6,2022,5,2
2022-05-05 03:54:57,23,27,20,42,29,BTC,13,7,2022,5,2
2022-05-05 07:04:02,3,1,0,2,2,BTC,0,1,2022,5,2
2022-05-05 13:59:33,12,17,2,19,1,BTC,18,15,2022,5,2
2022-05-05 14:16:58,9,15,0,24,1,BTC,23,15,2022,5,2
2022-05-05 14:24:10,4,3,1,3,3,BTC,0,2,2022,5,2
2022-05-05 14:24:59,5,6,1,7,1,BTC,6,5,2022,5,2
2022-05-05 14:57:34,3,2,2,2,14,BTC,-12,0,2022,5,2
2022-05-05 17:21:33,3,2,0,2,3,BTC,-1,2,2022,5,2
2022-05-05 18:55:46,3,0,0,0,0,BTC,0,0,2022,5,2
2022-05-05 19:00:05,5,6,0,9,1,BTC,8,6,2022,5,2
2022-05-05 19:30:43,3,3,0,7,1,BTC,6,3,2022,5,2
2022-05-05 20:00:40,33,42,3,55,6,BTC,49,39,2022,5,2
2022-05-05 20:30:00,4,7,0,5,2,BTC,3,7,2022,5,2
2022-05-05 21:35:22,6,12,0,18,0,BTC,18,12,2022,5,2
2022-05-06 05:42:19,4,7,0,6,2,BTC,4,7,2022,5,2
2022-05-06 09:27:29,3,3,0,0,3,BTC,-3,3,2022,5,2
2022-05-06 13:59:26,10,10,0,14,1,BTC,13,10,2022,5,2
2022-05-06 15:14:46,3,1,0,1,2,BTC,-1,1,2022,5,2
2022-05-06 15:17:23,3,2,3,3,9,BTC,-6,-1,2022,5,2
2022-05-06 15:38:59,28,46,1,63,2,BTC,61,45,2022,5,2
2022-05-06 16:29:40,6,1,4,0,8,BTC,-8,-3,2022,5,2
2022-05-06 20:00:14,8,13,0,14,1,BTC,13,13,2022,5,2
2022-05-06 20:23:32,3,1,2,6,8,BTC,-2,-1,2022,5,2
2022-05-06 20:30:30,27,48,0,56,1,BTC,55,48,2022,5,2
2022-05-07 07:04:11,7,1,0,2,4,BTC,-2,1,2022,5,2
2022-05-07 07:44:17,3,2,0,3,1,BTC,2,2,2022,5,2
2022-05-07 10:10:07,9,11,1,11,1,BTC,10,10,2022,5,2
2022-05-07 10:46:16,3,5,1,0,1,BTC,-1,4,2022,5,2
2022-05-07 11:08:09,11,7,6,8,8,BTC,0,1,2022,5,2
2022-05-07 14:31:24,4,2,1,2,9,BTC,-7,1,2022,5,2
2022-05-07 17:00:50,4,6,3,4,5,BTC,-1,3,2022,5,2
2022-05-07 17:58:05,11,24,0,31,1,BTC,30,24,2022,5,2
2022-05-07 19:24:00,3,12,4,15,1,BTC,14,8,2022,5,2
2022-05-08 10:19:33,3,4,0,4,0,BTC,4,4,2022,5,2
2022-05-08 10:54:36,3,2,0,2,0,BTC,2,2,2022,5,2
2022-05-08 12:45:16,5,6,0,7,1,BTC,6,6,2022,5,2
2022-05-08 13:42:33,7,6,3,5,8,BTC,-3,3,2022,5,2
2022-05-08 13:52:02,4,3,1,2,9,BTC,-7,2,2022,5,2
2022-05-08 15:19:11,16,24,3,38,6,BTC,32,21,2022,5,2
2022-05-08 23:45:18,12,14,1,23,2,BTC,21,13,2022,5,2
2022-05-09 06:26:47,5,8,0,13,0,BTC,13,8,2022,5,2
2022-05-09 09:14:30,13,6,19,4,19,BTC,-15,-13,2022,5,2
2022-05-09 09:31:22,3,2,2,0,2,BTC,-2,0,2022,5,2
2022-05-09 11:10:36,4,6,1,9,1,BTC,8,5,2022,5,2
2022-05-09 11:15:07,3,2,1,3,5,BTC,-2,1,2022,5,2
2022-05-09 11:48:48,3,3,0,4,1,BTC,3,3,2022,5,2
2022-05-09 12:11:52,6,3,1,2,7,BTC,-5,2,2022,5,2
2022-05-09 12:25:49,6,2,6,3,11,BTC,-8,-4,2022,5,2
2022-05-09 13:30:00,4,3,1,2,11,BTC,-9,2,2022,5,2
2022-05-09 14:30:51,3,4,0,5,1,BTC,4,4,2022,5,2
2022-05-09 15:04:38,9,14,8,6,22,BTC,-16,6,2022,5,2
2022-05-09 16:50:00,4,4,0,5,2,BTC,3,4,2022,5,2
2022-05-09 17:26:38,5,4,2,6,4,BTC,2,2,2022,5,2
2022-05-09 17:29:03,3,2,1,2,2,BTC,0,1,2022,5,2
2022-05-09 18:00:00,6,5,0,6,1,BTC,5,5,2022,5,2
2022-05-09 18:40:06,19,16,9,15,29,BTC,-14,7,2022,5,2
2022-05-09 19:06:54,7,4,2,4,8,BTC,-4,2,2022,5,2
2022-05-09 19:48:59,3,5,1,7,3,BTC,4,4,2022,5,2
2022-05-09 20:19:22,29,53,2,55,3,BTC,52,51,2022,5,2
2022-05-09 21:03:05,6,13,0,11,2,BTC,9,13,2022,5,2
2022-05-09 21:11:12,9,20,0,16,1,BTC,15,20,2022,5,2
2022-05-09 21:30:00,3,5,0,5,2,BTC,3,5,2022,5,2
2022-05-09 21:57:50,3,2,0,2,0,BTC,2,2,2022,5,2
2022-05-09 22:05:57,21,49,4,54,5,BTC,49,45,2022,5,2
2022-05-09 22:49:08,8,1,2,2,7,BTC,-5,-1,2022,5,2
2022-05-09 23:00:38,3,4,0,4,1,BTC,3,4,2022,5,2
2022-05-10 01:59:22,3,3,0,4,0,BTC,4,3,2022,5,2
2022-05-10 09:03:37,7,8,1,2,6,BTC,-4,7,2022,5,2
2022-05-10 09:19:11,6,4,0,3,5,BTC,-2,4,2022,5,2
2022-05-10 10:42:23,21,29,1,30,2,BTC,28,28,2022,5,2
2022-05-10 11:08:30,6,2,2,1,3,BTC,-2,0,2022,5,2
2022-05-10 11:22:29,6,13,0,10,0,BTC,10,13,2022,5,2
2022-05-10 12:41:43,9,7,2,1,7,BTC,-6,5,2022,5,2
2022-05-10 12:50:11,16,20,0,24,2,BTC,22,20,2022,5,2
2022-05-10 13:26:00,3,4,0,5,0,BTC,5,4,2022,5,2
2022-05-10 15:01:54,6,5,3,1,5,BTC,-4,2,2022,5,2
2022-05-10 15:15:07,5,6,0,7,1,BTC,6,6,2022,5,2
2022-05-10 15:15:11,7,12,0,12,1,BTC,11,12,2022,5,2
2022-05-10 15:43:25,5,5,1,1,7,BTC,-6,4,2022,5,2
2022-05-10 16:27:17,5,9,0,13,1,BTC,12,9,2022,5,2
2022-05-10 18:36:52,11,20,2,26,2,BTC,24,18,2022,5,2
2022-05-11 07:04:26,22,17,4,22,25,BTC,-3,13,2022,5,2
2022-05-11 08:47:23,4,2,1,0,5,BTC,-5,1,2022,5,2
2022-05-11 10:11:36,7,7,2,5,3,BTC,2,5,2022,5,2
2022-05-11 10:39:06,6,5,1,6,3,BTC,3,4,2022,5,2
2022-05-11 11:03:00,7,7,2,1,9,BTC,-8,5,2022,5,2
2022-05-11 13:26:10,3,1,0,1,3,BTC,-2,1,2022,5,2
2022-05-11 13:34:53,4,5,1,1,5,BTC,-4,4,2022,5,2
2022-05-11 15:05:29,4,6,0,6,1,BTC,5,6,2022,5,2
2022-05-11 15:39:52,5,7,1,8,1,BTC,7,6,2022,5,2
2022-05-11 18:46:15,14,29,2,42,3,BTC,39,27,2022,5,2
2022-05-11 19:57:20,8,9,1,11,2,BTC,9,8,2022,5,2
2022-05-11 20:00:00,9,8,0,10,0,BTC,10,8,2022,5,2
2022-05-11 20:48:45,3,2,0,3,1,BTC,2,2,2022,5,2
2022-05-11 21:27:30,3,2,1,4,6,BTC,-2,1,2022,5,2
2022-05-12 01:20:08,13,21,1,27,2,BTC,25,20,2022,5,2
2022-05-12 06:35:01,13,10,1,11,17,BTC,-6,9,2022,5,2
2022-05-12 07:45:00,6,16,0,22,0,BTC,22,16,2022,5,2
2022-05-12 09:58:55,14,24,0,33,0,BTC,33,24,2022,5,2
2022-05-12 11:34:45,7,4,5,5,4,BTC,1,-1,2022,5,2
2022-05-12 12:36:07,3,3,1,4,4,BTC,0,2,2022,5,2
2022-05-12 12:47:00,14,28,0,32,1,BTC,31,28,2022,5,2
2022-05-12 13:40:14,53,79,0,108,3,BTC,105,79,2022,5,2
2022-05-12 13:50:35,5,9,0,14,0,BTC,14,9,2022,5,2
2022-05-12 14:09:59,5,7,0,4,3,BTC,1,7,2022,5,2
2022-05-12 14:58:42,5,6,3,8,2,BTC,6,3,2022,5,2
2022-05-12 15:40:01,13,25,3,34,2,BTC,32,22,2022,5,2
2022-05-12 15:57:52,3,3,0,1,2,BTC,-1,3,2022,5,2
2022-05-12 17:34:49,3,2,0,4,0,BTC,4,2,2022,5,2
2022-05-12 18:05:08,8,19,2,22,3,BTC,19,17,2022,5,2
2022-05-12 18:07:55,6,10,8,8,9,BTC,-1,2,2022,5,2
2022-05-12 19:15:00,6,13,0,11,1,BTC,10,13,2022,5,2
2022-05-12 21:25:00,6,7,0,11,0,BTC,11,7,2022,5,2
2022-05-13 08:27:29,8,13,0,12,0,BTC,12,13,2022,5,2
2022-05-13 10:00:57,6,15,0,17,0,BTC,17,15,2022,5,2
2022-05-13 11:03:34,5,7,0,8,0,BTC,8,7,2022,5,2
2022-05-13 11:19:08,6,7,1,13,1,BTC,12,6,2022,5,2
2022-05-13 12:01:25,12,23,0,33,0,BTC,33,23,2022,5,2
2022-05-13 12:15:00,17,23,1,33,0,BTC,33,22,2022,5,2
2022-05-13 13:13:55,13,18,0,24,1,BTC,23,18,2022,5,2
2022-05-13 15:29:24,5,5,0,13,0,BTC,13,5,2022,5,2
2022-05-13 16:28:10,3,3,0,4,0,BTC,4,3,2022,5,2
2022-05-13 17:13:30,5,7,0,7,0,BTC,7,7,2022,5,2
2022-05-13 19:19:15,3,3,0,2,0,BTC,2,3,2022,5,2
2022-05-13 19:52:20,29,55,7,71,5,BTC,66,48,2022,5,2
2022-05-13 20:00:57,7,13,2,20,1,BTC,19,11,2022,5,2
2022-05-14 07:53:12,12,16,3,15,3,BTC,12,13,2022,5,2
2022-05-14 08:12:18,28,37,2,41,0,BTC,41,35,2022,5,2
2022-05-14 10:01:00,3,3,0,4,0,BTC,4,3,2022,5,2
2022-05-14 10:17:41,4,0,4,2,4,BTC,-2,-4,2022,5,2
2022-05-14 10:25:42,3,4,0,6,1,BTC,5,4,2022,5,2
2022-05-14 10:30:50,8,20,1,31,1,BTC,30,19,2022,5,2
2022-05-14 10:55:00,3,3,1,5,0,BTC,5,2,2022,5,2
2022-05-14 11:25:44,4,6,0,8,0,BTC,8,6,2022,5,2
2022-05-14 13:10:10,5,5,1,4,0,BTC,4,4,2022,5,2
2022-05-14 14:25:27,15,22,3,36,11,BTC,25,19,2022,5,2
2022-05-14 14:37:05,5,5,0,5,0,BTC,5,5,2022,5,2
2022-05-14 16:25:33,4,4,1,5,1,BTC,4,3,2022,5,2
2022-05-14 22:05:27,4,11,2,10,2,BTC,8,9,2022,5,2
2022-05-15 06:32:34,6,10,0,13,0,BTC,13,10,2022,5,2
2022-05-15 12:56:48,3,3,1,7,7,BTC,0,2,2022,5,2
2022-05-15 22:05:25,16,28,2,36,3,BTC,33,26,2022,5,2
2022-05-15 23:02:54,15,19,1,24,0,BTC,24,18,2022,5,2
2022-05-16 03:56:58,45,76,0,108,0,BTC,108,76,2022,5,2
2022-05-16 06:00:22,9,11,0,16,0,BTC,16,11,2022,5,2
2022-05-16 08:57:21,6,8,1,10,1,BTC,9,7,2022,5,2
2022-05-16 10:42:32,3,6,2,5,1,BTC,4,4,2022,5,2
2022-05-16 11:00:00,3,1,2,2,0,BTC,2,-1,2022,5,2
2022-05-16 11:00:58,4,4,0,3,4,BTC,-1,4,2022,5,2
2022-05-16 11:05:41,3,2,4,4,8,BTC,-4,-2,2022,5,2
2022-05-16 11:28:04,4,3,2,8,2,BTC,6,1,2022,5,2
2022-05-16 11:28:14,8,6,4,1,13,BTC,-12,2,2022,5,2
2022-05-16 11:37:19,11,21,1,28,0,BTC,28,20,2022,5,2
2022-05-16 11:47:29,3,5,0,4,0,BTC,4,5,2022,5,2
2022-05-16 13:20:55,3,4,3,6,7,BTC,-1,1,2022,5,2
2022-05-16 13:56:29,10,10,1,21,0,BTC,21,9,2022,5,2
2022-05-16 15:04:07,4,7,1,6,0,BTC,6,6,2022,5,2
2022-05-16 15:28:44,3,3,0,4,0,BTC,4,3,2022,5,2
2022-05-16 15:37:52,3,4,0,3,0,BTC,3,4,2022,5,2
2022-05-16 15:44:25,17,31,2,45,1,BTC,44,29,2022,5,2
2022-05-16 17:02:38,6,9,0,11,0,BTC,11,9,2022,5,2
2022-05-16 19:55:07,3,4,0,2,2,BTC,0,4,2022,5,2
2022-05-17 05:59:16,3,5,0,5,0,BTC,5,5,2022,5,2
2022-05-17 08:20:00,9,26,0,41,2,BTC,39,26,2022,5,2
2022-05-17 09:50:20,5,11,0,12,0,BTC,12,11,2022,5,2
2022-05-17 11:56:51,9,5,5,7,5,BTC,2,0,2022,5,2
2022-05-17 13:47:31,6,4,2,3,4,BTC,-1,2,2022,5,2
2022-05-17 16:12:45,5,8,2,9,2,BTC,7,6,2022,5,2
2022-05-17 21:18:06,9,8,0,11,0,BTC,11,8,2022,5,2
2022-05-18 02:00:00,6,16,3,10,2,BTC,8,13,2022,5,2
2022-05-18 10:08:00,4,4,0,4,0,BTC,4,4,2022,5,2
2022-05-18 12:47:25,8,9,1,11,0,BTC,11,8,2022,5,2
2022-05-18 13:25:00,4,4,0,4,0,BTC,4,4,2022,5,2
2022-05-18 14:03:27,7,7,0,5,0,BTC,5,7,2022,5,2
2022-05-18 14:40:36,12,11,11,10,19,BTC,-9,0,2022,5,2
2022-05-18 17:00:32,10,23,6,37,15,BTC,22,17,2022,5,2
2022-05-18 18:12:17,4,4,4,7,4,BTC,3,0,2022,5,2
2022-05-18 18:23:08,21,31,0,51,2,BTC,49,31,2022,5,2
2022-05-18 19:00:50,3,0,0,0,2,BTC,-2,0,2022,5,2
2022-05-18 20:34:14,5,8,2,11,2,BTC,9,6,2022,5,2
2022-05-18 22:06:50,4,6,0,9,0,BTC,9,6,2022,5,2
2022-05-19 06:48:24,17,22,1,39,1,BTC,38,21,2022,5,2
2022-05-19 09:54:04,7,4,2,4,3,BTC,1,2,2022,5,2
2022-05-19 11:30:02,4,3,0,3,0,BTC,3,3,2022,5,2
2022-05-19 11:45:57,3,3,1,3,1,BTC,2,2,2022,5,2
2022-05-19 13:01:17,4,0,9,2,1,BTC,1,-9,2022,5,2
2022-05-19 14:28:00,5,6,1,7,1,BTC,6,5,2022,5,2
2022-05-19 15:26:34,6,8,1,10,0,BTC,10,7,2022,5,2
2022-05-19 16:00:50,4,3,0,3,0,BTC,3,3,2022,5,2
2022-05-19 18:45:22,8,9,16,14,14,BTC,0,-7,2022,5,2
2022-05-19 20:03:26,3,3,0,5,0,BTC,5,3,2022,5,2
2022-05-19 20:30:00,3,3,0,1,0,BTC,1,3,2022,5,2
2022-05-20 10:49:39,11,28,1,33,2,BTC,31,27,2022,5,2
2022-05-20 11:49:00,3,5,0,7,0,BTC,7,5,2022,5,2
2022-05-20 13:30:06,9,2,3,4,7,BTC,-3,-1,2022,5,2
2022-05-20 13:33:18,11,7,1,2,7,BTC,-5,6,2022,5,2
2022-05-20 13:45:00,5,7,0,10,0,BTC,10,7,2022,5,2
2022-05-20 15:48:55,3,3,0,3,0,BTC,3,3,2022,5,2
2022-05-20 16:27:18,6,9,1,7,0,BTC,7,8,2022,5,2
2022-05-20 17:18:03,12,16,1,16,0,BTC,16,15,2022,5,2
2022-05-20 17:30:32,8,14,0,12,0,BTC,12,14,2022,5,2
2022-05-20 19:36:46,14,23,1,37,0,BTC,37,22,2022,5,2
2022-05-20 20:18:30,4,5,0,8,0,BTC,8,5,2022,5,2
2022-05-20 21:27:44,4,4,1,4,0,BTC,4,3,2022,5,2
2022-05-21 07:47:41,10,9,3,7,6,BTC,1,6,2022,5,2
2022-05-21 09:30:19,14,24,0,32,0,BTC,32,24,2022,5,2
2022-05-21 20:57:28,7,7,8,11,5,BTC,6,-1,2022,5,2
2022-05-21 21:17:50,12,15,1,24,1,BTC,23,14,2022,5,2
2022-05-22 05:18:00,3,3,0,1,2,BTC,-1,3,2022,5,2
2022-05-22 08:49:53,28,50,7,58,4,BTC,54,43,2022,5,2
2022-05-22 12:03:47,4,2,7,5,7,BTC,-2,-5,2022,5,2
2022-05-22 13:08:07,9,11,0,14,0,BTC,14,11,2022,5,2
2022-05-22 13:37:04,27,27,3,40,0,BTC,40,24,2022,5,2
2022-05-22 16:00:08,4,17,0,14,0,BTC,14,17,2022,5,2
2022-05-22 21:32:14,4,5,0,7,0,BTC,7,5,2022,5,2
2022-05-23 10:04:00,3,5,0,10,0,BTC,10,5,2022,5,2
2022-05-23 10:41:03,7,6,0,4,1,BTC,3,6,2022,5,2
2022-05-23 11:24:53,3,4,0,4,0,BTC,4,4,2022,5,2
2022-05-23 11:26:54,4,8,0,7,0,BTC,7,8,2022,5,2
2022-05-23 11:30:29,7,7,2,6,2,BTC,4,5,2022,5,2
2022-05-23 11:57:19,3,3,0,5,0,BTC,5,3,2022,5,2
2022-05-23 12:36:15,8,11,2,8,0,BTC,8,9,2022,5,2
2022-05-23 13:39:40,29,42,4,46,3,BTC,43,38,2022,5,2
2022-05-23 14:55:33,7,4,3,4,2,BTC,2,1,2022,5,2
2022-05-23 15:18:22,7,9,0,13,1,BTC,12,9,2022,5,2
2022-05-23 16:03:10,7,6,1,8,0,BTC,8,5,2022,5,2
2022-05-23 19:00:18,3,3,11,6,8,BTC,-2,-8,2022,5,2
2022-05-23 23:00:16,6,7,0,11,4,BTC,7,7,2022,5,2
2022-05-24 02:35:07,3,6,0,6,0,BTC,6,6,2022,5,2
2022-05-24 05:57:49,4,4,1,9,2,BTC,7,3,2022,5,2
2022-05-24 10:49:50,4,3,0,4,0,BTC,4,3,2022,5,2
2022-05-24 11:10:45,8,7,6,8,1,BTC,7,1,2022,5,2
2022-05-24 11:58:31,17,23,2,34,2,BTC,32,21,2022,5,2
2022-05-24 12:44:57,4,6,0,6,0,BTC,6,6,2022,5,2
2022-05-24 13:51:47,16,27,0,29,1,BTC,28,27,2022,5,2
2022-05-24 14:08:52,10,20,1,24,1,BTC,23,19,2022,5,2
2022-05-24 14:12:12,10,21,0,23,1,BTC,22,21,2022,5,2
2022-05-24 17:18:00,3,3,0,4,0,BTC,4,3,2022,5,2
2022-05-24 17:46:31,5,7,0,10,0,BTC,10,7,2022,5,2
2022-05-24 17:46:34,3,0,6,6,2,BTC,4,-6,2022,5,2
2022-05-24 18:29:38,6,8,0,9,0,BTC,9,8,2022,5,2
2022-05-25 02:19:13,3,4,4,7,2,BTC,5,0,2022,5,2
2022-05-25 09:22:59,15,18,3,11,19,BTC,-8,15,2022,5,2
2022-05-25 10:09:25,7,7,1,8,0,BTC,8,6,2022,5,2
2022-05-25 11:41:03,6,9,0,10,0,BTC,10,9,2022,5,2
2022-05-25 13:43:02,35,50,4,64,2,BTC,62,46,2022,5,2
2022-05-25 14:31:11,6,9,0,13,0,BTC,13,9,2022,5,2
2022-05-25 15:40:00,3,5,1,4,1,BTC,3,4,2022,5,2
2022-05-25 15:43:14,10,16,0,24,0,BTC,24,16,2022,5,2
2022-05-25 18:15:00,4,8,0,9,0,BTC,9,8,2022,5,2
2022-05-25 20:06:56,3,4,1,5,2,BTC,3,3,2022,5,2
2022-05-26 05:47:34,3,5,1,8,0,BTC,8,4,2022,5,2
2022-05-26 08:08:51,24,24,2,28,3,BTC,25,22,2022,5,2
2022-05-26 09:04:53,9,9,0,12,0,BTC,12,9,2022,5,2
2022-05-26 09:18:25,7,11,1,14,0,BTC,14,10,2022,5,2
2022-05-26 10:46:11,6,7,0,8,0,BTC,8,7,2022,5,2
2022-05-26 14:03:35,5,6,0,4,0,BTC,4,6,2022,5,2
2022-05-26 14:22:30,7,8,1,10,0,BTC,10,7,2022,5,2
2022-05-26 14:47:10,5,9,0,12,0,BTC,12,9,2022,5,2
2022-05-26 16:20:28,23,47,5,46,5,BTC,41,42,2022,5,2
2022-05-26 20:58:50,3,3,0,6,0,BTC,6,3,2022,5,2
2022-05-26 22:01:44,3,6,0,7,0,BTC,7,6,2022,5,2
2022-05-27 02:14:38,9,9,0,12,0,BTC,12,9,2022,5,2
2022-05-27 09:57:30,4,5,3,4,2,BTC,2,2,2022,5,2
2022-05-27 10:05:00,5,5,0,5,1,BTC,4,5,2022,5,2
2022-05-27 15:08:42,21,25,0,42,0,BTC,42,25,2022,5,2
2022-05-27 15:14:34,5,3,2,1,6,BTC,-5,1,2022,5,2
2022-05-27 19:00:00,7,10,0,12,0,BTC,12,10,2022,5,2
2022-05-27 20:06:09,3,0,0,1,1,BTC,0,0,2022,5,2
2022-05-27 21:09:23,22,44,4,54,6,BTC,48,40,2022,5,2
2022-05-28 06:53:44,5,0,5,2,6,BTC,-4,-5,2022,5,2
2022-05-28 09:59:55,7,5,1,4,1,BTC,3,4,2022,5,2
2022-05-28 11:40:09,7,11,5,9,4,BTC,5,6,2022,5,2
2022-05-28 16:01:00,45,62,14,85,12,BTC,73,48,2022,5,2
2022-05-28 19:17:24,5,10,0,9,1,BTC,8,10,2022,5,2
2022-05-28 19:50:00,3,2,0,4,0,BTC,4,2,2022,5,2
2022-05-28 20:02:56,4,3,2,1,1,BTC,0,1,2022,5,2
2022-05-29 07:25:08,15,18,0,22,0,BTC,22,18,2022,5,2
2022-05-29 08:20:34,3,5,0,6,0,BTC,6,5,2022,5,2
2022-05-29 08:42:26,3,4,0,1,5,BTC,-4,4,2022,5,2
2022-05-29 11:00:31,5,6,1,6,0,BTC,6,5,2022,5,2
2022-05-29 12:48:51,8,12,0,14,0,BTC,14,12,2022,5,2
2022-05-29 13:10:27,7,17,2,12,0,BTC,12,15,2022,5,2
2022-05-29 14:30:20,4,3,0,1,0,BTC,1,3,2022,5,2
2022-05-29 18:19:54,5,8,0,9,2,BTC,7,8,2022,5,2
2022-05-29 19:36:21,3,4,1,4,1,BTC,3,3,2022,5,2
2022-05-30 00:43:07,7,7,1,8,4,BTC,4,6,2022,5,2
2022-05-30 09:00:34,8,11,6,12,5,BTC,7,5,2022,5,2
2022-05-30 10:58:33,13,10,3,11,1,BTC,10,7,2022,5,2
2022-05-30 12:07:32,3,4,0,4,0,BTC,4,4,2022,5,2
2022-05-30 12:47:51,9,8,2,8,0,BTC,8,6,2022,5,2
2022-05-30 12:57:16,6,7,2,10,0,BTC,10,5,2022,5,2
2022-05-30 14:30:17,3,4,0,4,0,BTC,4,4,2022,5,2
2022-05-30 14:30:48,3,4,0,3,1,BTC,2,4,2022,5,2
2022-05-30 15:25:51,9,19,1,21,1,BTC,20,18,2022,5,2
2022-05-30 17:23:36,3,3,5,4,7,BTC,-3,-2,2022,5,2
2022-05-30 17:43:24,4,5,0,5,0,BTC,5,5,2022,5,2
2022-05-30 18:17:47,29,45,8,52,5,BTC,47,37,2022,5,2
2022-05-30 20:42:37,3,5,0,5,0,BTC,5,5,2022,5,2
2022-05-30 22:27:11,7,5,6,6,4,BTC,2,-1,2022,5,2
2022-05-31 09:09:35,4,5,2,1,5,BTC,-4,3,2022,5,2
2022-05-31 09:30:00,3,4,0,4,0,BTC,4,4,2022,5,2
2022-05-31 09:52:27,5,4,1,6,0,BTC,6,3,2022,5,2
2022-05-31 11:05:00,5,7,1,9,0,BTC,9,6,2022,5,2
2022-05-31 16:25:40,3,3,1,2,2,BTC,0,2,2022,5,2
2022-05-31 17:30:25,3,7,3,6,3,BTC,3,4,2022,5,2
2022-06-01 07:04:04,4,8,4,8,4,BTC,4,4,2022,6,2
2022-06-01 13:32:18,6,10,0,12,0,BTC,12,10,2022,6,2
2022-06-01 14:11:43,17,29,2,35,2,BTC,33,27,2022,6,2
2022-06-01 14:40:00,3,4,1,5,0,BTC,5,3,2022,6,2
2022-06-01 14:59:58,4,6,0,5,0,BTC,5,6,2022,6,2
2022-06-01 16:09:00,3,5,1,5,0,BTC,5,4,2022,6,2
2022-06-01 21:30:09,8,16,3,20,1,BTC,19,13,2022,6,2
2022-06-02 03:59:27,3,2,2,2,1,BTC,1,0,2022,6,2
2022-06-02 09:45:01,7,11,2,11,2,BTC,9,9,2022,6,2
2022-06-02 13:28:45,6,4,2,4,2,BTC,2,2,2022,6,2
2022-06-02 14:09:08,3,3,1,5,1,BTC,4,2,2022,6,2
2022-06-02 16:46:00,9,12,1,14,0,BTC,14,11,2022,6,2
2022-06-02 18:37:39,5,6,0,7,1,BTC,6,6,2022,6,2
2022-06-03 01:28:02,4,2,0,2,1,BTC,1,2,2022,6,2
2022-06-03 02:00:00,6,10,2,12,1,BTC,11,8,2022,6,2
2022-06-03 08:27:12,29,15,21,8,45,BTC,-37,-6,2022,6,2
2022-06-03 10:30:00,4,2,0,0,4,BTC,-4,2,2022,6,2
2022-06-03 11:30:23,3,4,0,3,0,BTC,3,4,2022,6,2
2022-06-03 14:02:18,4,6,0,6,0,BTC,6,6,2022,6,2
2022-06-03 18:00:00,5,12,0,11,0,BTC,11,12,2022,6,2
2022-06-03 21:01:20,5,3,6,4,7,BTC,-3,-3,2022,6,2
2022-06-03 22:05:36,4,1,2,3,3,BTC,0,-1,2022,6,2
2022-06-04 07:22:43,4,8,0,11,0,BTC,11,8,2022,6,2
2022-06-04 10:10:05,25,43,4,46,4,BTC,42,39,2022,6,2
2022-06-04 11:45:00,3,0,2,0,3,BTC,-3,-2,2022,6,2
2022-06-04 11:45:57,3,6,1,2,6,BTC,-4,5,2022,6,2
2022-06-04 14:39:00,4,5,6,4,5,BTC,-1,-1,2022,6,2
2022-06-04 17:12:04,24,37,5,48,8,BTC,40,32,2022,6,2
2022-06-04 17:45:00,6,8,9,10,15,BTC,-5,-1,2022,6,2
2022-06-04 22:00:22,3,4,0,6,0,BTC,6,4,2022,6,2
2022-06-05 11:00:00,3,3,1,2,1,BTC,1,2,2022,6,2
2022-06-05 12:09:13,6,13,1,11,0,BTC,11,12,2022,6,2
2022-06-05 14:00:00,3,3,2,3,1,BTC,2,1,2022,6,2
2022-06-05 14:40:47,5,9,0,7,0,BTC,7,9,2022,6,2
2022-06-05 15:10:56,6,12,9,13,11,BTC,2,3,2022,6,2
2022-06-05 15:46:42,4,4,4,5,6,BTC,-1,0,2022,6,2
2022-06-05 16:08:55,7,8,0,6,0,BTC,6,8,2022,6,2
2022-06-05 17:00:00,14,19,9,25,5,BTC,20,10,2022,6,2
2022-06-05 17:56:28,4,8,0,8,0,BTC,8,8,2022,6,2
2022-06-05 20:24:51,3,6,2,10,2,BTC,8,4,2022,6,2
2022-06-06 03:08:09,3,8,1,12,0,BTC,12,7,2022,6,2
2022-06-06 06:30:09,17,36,2,48,2,BTC,46,34,2022,6,2
2022-06-06 08:46:56,4,6,0,5,0,BTC,5,6,2022,6,2
2022-06-06 09:23:38,8,10,0,11,0,BTC,11,10,2022,6,2
2022-06-06 09:47:23,4,7,0,8,0,BTC,8,7,2022,6,2
2022-06-06 10:07:17,4,5,0,7,0,BTC,7,5,2022,6,2
2022-06-06 11:57:47,3,3,0,3,0,BTC,3,3,2022,6,2
2022-06-06 12:05:31,6,7,2,5,3,BTC,2,5,2022,6,2
2022-06-06 12:33:38,5,5,2,5,1,BTC,4,3,2022,6,2
2022-06-06 14:02:21,10,8,10,7,16,BTC,-9,-2,2022,6,2
2022-06-06 17:34:22,7,5,3,6,7,BTC,-1,2,2022,6,2
2022-06-06 19:27:27,5,9,0,9,1,BTC,8,9,2022,6,2
2022-06-06 20:59:47,5,7,2,9,0,BTC,9,5,2022,6,2
2022-06-07 10:08:39,3,2,2,2,1,BTC,1,0,2022,6,2
2022-06-07 10:10:26,4,2,1,1,6,BTC,-5,1,2022,6,2
2022-06-07 10:10:37,6,6,0,7,0,BTC,7,6,2022,6,2
2022-06-07 11:00:37,4,4,2,4,3,BTC,1,2,2022,6,2
2022-06-07 12:23:29,4,9,0,8,0,BTC,8,9,2022,6,2
2022-06-07 12:29:30,4,5,1,7,0,BTC,7,4,2022,6,2
2022-06-07 13:40:36,6,4,2,2,5,BTC,-3,2,2022,6,2
2022-06-07 15:06:53,5,6,0,5,0,BTC,5,6,2022,6,2
2022-06-07 15:09:13,6,2,4,2,3,BTC,-1,-2,2022,6,2
2022-06-07 15:23:45,3,5,0,6,0,BTC,6,5,2022,6,2
2022-06-07 15:41:21,7,9,0,10,0,BTC,10,9,2022,6,2
2022-06-07 17:06:01,8,11,0,14,0,BTC,14,11,2022,6,2
2022-06-07 17:35:16,7,10,3,10,4,BTC,6,7,2022,6,2
2022-06-07 17:42:06,9,11,0,9,0,BTC,9,11,2022,6,2
2022-06-07 18:45:07,4,6,0,7,0,BTC,7,6,2022,6,2
2022-06-07 18:52:23,12,19,0,18,0,BTC,18,19,2022,6,2
2022-06-08 01:09:55,6,6,0,8,0,BTC,8,6,2022,6,2
2022-06-08 09:40:01,4,3,2,1,6,BTC,-5,1,2022,6,2
2022-06-08 11:03:00,6,5,0,3,4,BTC,-1,5,2022,6,2
2022-06-08 14:20:22,4,5,0,4,0,BTC,4,5,2022,6,2
2022-06-08 14:25:08,11,14,4,16,7,BTC,9,10,2022,6,2
2022-06-08 15:47:55,25,38,1,48,1,BTC,47,37,2022,6,2
2022-06-08 15:56:32,5,3,0,6,0,BTC,6,3,2022,6,2
2022-06-08 16:03:13,3,5,1,6,0,BTC,6,4,2022,6,2
2022-06-08 19:00:38,6,3,1,3,2,BTC,1,2,2022,6,2
2022-06-08 19:09:20,24,30,3,36,3,BTC,33,27,2022,6,2
2022-06-09 00:50:09,7,11,0,7,1,BTC,6,11,2022,6,2
2022-06-09 16:55:57,5,7,0,8,0,BTC,8,7,2022,6,2
2022-06-11 16:55:55,3,2,0,2,0,BTC,2,2,2022,6,2
2022-06-12 05:10:12,10,5,7,6,12,BTC,-6,-2,2022,6,2
2022-06-14 05:26:48,3,1,1,1,4,BTC,-3,0,2022,6,2
2022-06-16 09:35:56,5,5,2,6,1,BTC,5,3,2022,6,2
2022-06-16 17:21:22,3,6,0,6,0,BTC,6,6,2022,6,2
2022-06-17 19:00:14,5,8,1,7,2,BTC,5,7,2022,6,2
2022-06-18 08:52:18,5,8,1,5,5,BTC,0,7,2022,6,2
2022-06-18 10:54:35,3,3,1,6,4,BTC,2,2,2022,6,2
2022-06-19 07:49:07,3,1,1,2,3,BTC,-1,0,2022,6,2
2022-06-19 11:22:23,4,11,6,9,6,BTC,3,5,2022,6,2
2022-06-19 15:30:03,38,70,1,80,3,BTC,77,69,2022,6,2
2022-06-20 03:59:27,3,2,1,6,1,BTC,5,1,2022,6,2
2022-06-20 05:57:07,6,12,1,12,1,BTC,11,11,2022,6,2
2022-06-20 11:58:40,3,2,2,0,3,BTC,-3,0,2022,6,2
2022-06-20 14:51:11,3,2,0,3,0,BTC,3,2,2022,6,2
2022-06-21 08:57:13,5,3,5,1,10,BTC,-9,-2,2022,6,2
2022-06-21 13:40:31,3,5,4,6,5,BTC,1,1,2022,6,2
2022-06-22 18:00:08,3,0,2,0,4,BTC,-4,-2,2022,6,2
2022-06-23 12:11:18,6,9,1,13,1,BTC,12,8,2022,6,2
2022-06-24 09:03:11,7,8,1,7,1,BTC,6,7,2022,6,2
2022-06-24 11:12:40,4,8,1,5,2,BTC,3,7,2022,6,2
2022-06-24 11:45:00,3,4,7,6,7,BTC,-1,-3,2022,6,2
2022-06-24 19:00:43,7,6,3,0,9,BTC,-9,3,2022,6,2
2022-06-28 10:30:24,3,3,7,4,8,BTC,-4,-4,2022,6,2
2022-06-28 19:36:05,41,8,24,5,24,BTC,-19,-16,2022,6,2
2022-06-29 12:03:07,5,2,0,1,5,BTC,-4,2,2022,6,2
2022-06-30 11:45:05,8,16,4,17,7,BTC,10,12,2022,6,2
2022-06-30 12:56:03,8,7,4,6,9,BTC,-3,3,2022,6,2
2022-07-02 18:42:12,5,2,4,3,5,BTC,-2,-2,2022,7,3
2022-07-03 11:45:08,4,4,1,1,2,BTC,-1,3,2022,7,3
2022-07-03 13:28:18,3,4,4,7,4,BTC,3,0,2022,7,3
2022-07-03 14:27:55,4,4,2,2,2,BTC,0,2,2022,7,3
2022-07-03 20:15:00,6,8,2,7,2,BTC,5,6,2022,7,3
2022-07-04 19:14:28,37,61,7,56,20,BTC,36,54,2022,7,3
2022-07-05 10:56:37,12,17,8,18,5,BTC,13,9,2022,7,3
2022-07-05 15:08:01,5,6,3,6,5,BTC,1,3,2022,7,3
2022-07-06 23:00:14,4,1,2,1,2,BTC,-1,-1,2022,7,3
2022-07-07 15:58:31,23,33,3,46,4,BTC,42,30,2022,7,3
2022-07-07 19:10:17,17,17,20,30,8,BTC,22,-3,2022,7,3
2022-07-09 05:53:00,3,1,0,0,4,BTC,-4,1,2022,7,3
2022-07-11 04:23:00,5,7,0,9,1,BTC,8,7,2022,7,3
2022-07-11 16:55:37,5,4,4,5,5,BTC,0,0,2022,7,3
2022-07-11 17:57:02,14,13,2,5,19,BTC,-14,11,2022,7,3
2022-07-13 01:50:33,6,4,4,2,13,BTC,-11,0,2022,7,3
2022-07-14 10:00:45,3,5,2,4,2,BTC,2,3,2022,7,3
2022-07-14 14:14:31,3,7,0,7,0,BTC,7,7,2022,7,3
2022-07-15 19:00:00,6,4,6,4,9,BTC,-5,-2,2022,7,3
2022-07-16 22:05:45,3,4,2,5,1,BTC,4,2,2022,7,3
2022-07-18 19:30:00,5,7,0,7,0,BTC,7,7,2022,7,3
2022-07-20 19:44:22,3,5,0,5,0,BTC,5,5,2022,7,3
2022-07-20 20:22:42,9,12,8,14,16,BTC,-2,4,2022,7,3
2022-07-20 21:33:57,5,10,1,10,5,BTC,5,9,2022,7,3
2022-07-20 22:33:15,6,6,5,3,12,BTC,-9,1,2022,7,3
2022-07-21 08:53:27,6,10,1,14,1,BTC,13,9,2022,7,3
2022-07-21 11:56:48,13,18,1,20,0,BTC,20,17,2022,7,3
2022-07-23 14:30:04,3,9,1,9,2,BTC,7,8,2022,7,3
2022-07-23 18:59:31,13,14,6,16,5,BTC,11,8,2022,7,3
2022-07-24 13:06:42,7,9,3,13,3,BTC,10,6,2022,7,3
2022-07-24 18:44:23,3,2,1,0,5,BTC,-5,1,2022,7,3
2022-07-26 13:36:52,3,3,1,3,3,BTC,0,2,2022,7,3
2022-07-26 19:00:15,5,5,1,5,1,BTC,4,4,2022,7,3
2022-07-26 23:00:18,3,6,1,7,3,BTC,4,5,2022,7,3
2022-07-27 14:15:04,6,6,2,7,2,BTC,5,4,2022,7,3
2022-07-29 19:55:10,4,5,0,6,0,BTC,6,5,2022,7,3
2022-07-30 01:53:06,13,17,2,19,2,BTC,17,15,2022,7,3
2022-07-30 07:39:09,4,5,5,5,6,BTC,-1,0,2022,7,3
2022-07-30 11:24:24,4,5,3,1,3,BTC,-2,2,2022,7,3
2022-07-31 05:45:03,3,10,1,8,2,BTC,6,9,2022,7,3
2022-08-03 04:06:00,24,7,10,5,35,BTC,-30,-3,2022,8,3
2022-08-04 20:10:36,3,3,5,3,7,BTC,-4,-2,2022,8,3
2022-08-05 17:00:56,5,6,2,6,2,BTC,4,4,2022,8,3
2022-08-05 19:00:26,3,6,4,5,6,BTC,-1,2,2022,8,3
2022-08-07 22:05:28,4,8,3,10,2,BTC,8,5,2022,8,3
2022-08-08 11:45:18,4,5,1,6,2,BTC,4,4,2022,8,3
2022-08-08 14:12:11,5,7,1,10,1,BTC,9,6,2022,8,3
2022-08-09 07:38:44,10,13,2,21,3,BTC,18,11,2022,8,3
2022-08-09 18:05:37,7,15,5,13,5,BTC,8,10,2022,8,3
2022-08-09 19:00:45,6,3,1,2,11,BTC,-9,2,2022,8,3
2022-08-10 19:11:30,7,10,3,12,4,BTC,8,7,2022,8,3
2022-08-10 23:00:04,3,2,0,1,4,BTC,-3,2,2022,8,3
2022-08-11 10:26:00,4,8,3,8,4,BTC,4,5,2022,8,3
2022-08-11 11:03:20,3,7,2,7,3,BTC,4,5,2022,8,3
2022-08-13 16:13:29,6,1,2,0,7,BTC,-7,-1,2022,8,3
2022-08-14 10:01:11,3,7,0,6,1,BTC,5,7,2022,8,3
2022-08-16 12:25:28,9,11,0,14,2,BTC,12,11,2022,8,3
2022-08-16 13:00:27,3,6,1,6,0,BTC,6,5,2022,8,3
2022-08-16 17:50:40,13,14,20,14,26,BTC,-12,-6,2022,8,3
2022-08-18 09:18:49,6,5,0,7,0,BTC,7,5,2022,8,3
2022-08-19 10:20:51,3,1,0,3,4,BTC,-1,1,2022,8,3
2022-08-19 14:00:01,5,4,3,1,6,BTC,-5,1,2022,8,3
2022-08-20 00:00:00,5,10,0,16,0,BTC,16,10,2022,8,3
2022-08-20 23:30:38,3,5,3,9,4,BTC,5,2,2022,8,3
2022-08-25 10:47:15,7,9,1,10,1,BTC,9,8,2022,8,3
2022-08-25 18:45:26,13,12,1,22,1,BTC,21,11,2022,8,3
2022-08-27 11:48:15,3,6,2,1,7,BTC,-6,4,2022,8,3
2022-08-27 18:43:50,3,1,3,1,6,BTC,-5,-2,2022,8,3
2022-08-29 18:10:32,13,21,2,24,3,BTC,21,19,2022,8,3
2022-09-10 02:25:00,5,6,3,5,3,BTC,2,3,2022,9,3
2022-09-10 07:04:09,8,4,5,5,8,BTC,-3,-1,2022,9,3
2022-09-10 12:01:24,9,7,6,5,11,BTC,-6,1,2022,9,3
2022-09-10 14:55:01,10,12,1,14,2,BTC,12,11,2022,9,3
2022-09-11 14:54:50,3,1,1,1,2,BTC,-1,0,2022,9,3
2022-09-12 12:30:37,3,5,0,6,2,BTC,4,5,2022,9,3
2022-09-15 16:00:43,4,1,3,3,6,BTC,-3,-2,2022,9,3
2022-09-18 20:47:21,6,15,0,11,1,BTC,10,15,2022,9,3
2022-09-19 22:56:00,5,3,4,5,8,BTC,-3,-1,2022,9,3
2022-09-21 03:08:00,5,7,1,9,1,BTC,8,6,2022,9,3
2022-09-21 13:56:10,5,2,2,2,5,BTC,-3,0,2022,9,3
2022-09-21 16:48:16,12,8,8,8,13,BTC,-5,0,2022,9,3
2022-09-22 18:58:17,3,3,0,4,0,BTC,4,3,2022,9,3
2022-09-22 23:00:37,5,9,3,8,3,BTC,5,6,2022,9,3
2022-09-23 19:00:22,4,7,1,7,1,BTC,6,6,2022,9,3
2022-09-24 05:48:48,4,6,0,8,0,BTC,8,6,2022,9,3
2022-09-27 04:33:13,4,6,1,7,1,BTC,6,5,2022,9,3
2022-09-27 11:35:13,5,2,6,0,6,BTC,-6,-4,2022,9,3
2022-09-28 11:55:59,4,2,1,1,3,BTC,-2,1,2022,9,3
2022-09-30 10:44:56,15,19,2,20,3,BTC,17,17,2022,9,3
2022-10-01 00:42:12,6,13,0,13,0,BTC,13,13,2022,10,4
2022-10-02 19:00:51,4,9,1,13,1,BTC,12,8,2022,10,4
2022-10-04 19:33:20,6,9,2,10,1,BTC,9,7,2022,10,4
2022-10-04 23:00:26,4,6,5,9,5,BTC,4,1,2022,10,4
2022-10-05 19:15:09,4,7,1,9,1,BTC,8,6,2022,10,4
2022-10-06 00:45:15,12,12,0,15,0,BTC,15,12,2022,10,4
2022-10-07 17:00:35,3,1,3,0,3,BTC,-3,-2,2022,10,4
2022-10-07 20:00:02,3,5,2,5,2,BTC,3,3,2022,10,4
2022-10-09 13:10:19,4,7,2,9,2,BTC,7,5,2022,10,4
2022-10-10 01:56:35,6,11,1,12,1,BTC,11,10,2022,10,4
2022-10-10 19:00:34,6,6,1,7,3,BTC,4,5,2022,10,4
2022-10-13 14:25:34,3,3,3,4,3,BTC,1,0,2022,10,4
2022-10-13 18:41:43,6,8,6,10,5,BTC,5,2,2022,10,4
2022-10-14 11:45:58,3,1,2,1,3,BTC,-2,-1,2022,10,4
2022-10-17 17:00:55,5,8,0,7,1,BTC,6,8,2022,10,4
2022-10-21 09:15:51,6,6,1,6,2,BTC,4,5,2022,10,4
2022-10-23 16:55:48,5,14,0,12,0,BTC,12,14,2022,10,4
2022-10-26 11:40:00,10,14,3,13,4,BTC,9,11,2022,10,4
2022-10-26 18:05:50,5,7,6,4,18,BTC,-14,1,2022,10,4
2022-10-27 04:25:05,5,11,2,12,3,BTC,9,9,2022,10,4
2022-10-27 11:42:27,9,10,2,10,3,BTC,7,8,2022,10,4
2022-10-27 13:49:56,6,9,3,9,4,BTC,5,6,2022,10,4
2022-10-28 09:13:04,3,3,0,1,3,BTC,-2,3,2022,10,4
2022-10-30 14:25:49,4,6,2,3,2,BTC,1,4,2022,10,4
2022-10-31 12:26:24,3,2,0,2,0,BTC,2,2,2022,10,4
2022-10-31 16:16:57,7,10,1,8,1,BTC,7,9,2022,10,4
2022-11-02 13:39:50,5,4,1,6,0,BTC,6,3,2022,11,4
2022-11-02 18:00:58,5,6,3,10,1,BTC,9,3,2022,11,4
2022-11-02 19:14:23,9,12,0,12,0,BTC,12,12,2022,11,4
2022-11-03 19:55:26,12,14,2,16,2,BTC,14,12,2022,11,4
2022-11-03 23:00:21,7,15,6,18,8,BTC,10,9,2022,11,4
2022-11-04 19:00:23,6,14,1,12,2,BTC,10,13,2022,11,4
2022-11-07 11:57:00,3,5,1,5,3,BTC,2,4,2022,11,4
2022-11-07 12:39:00,3,5,0,5,0,BTC,5,5,2022,11,4
2022-11-08 16:42:27,4,8,0,8,0,BTC,8,8,2022,11,4
2022-11-08 19:46:16,3,3,0,1,4,BTC,-3,3,2022,11,4
2022-11-08 20:48:50,7,3,3,2,7,BTC,-5,0,2022,11,4
2022-11-08 23:20:52,3,1,2,0,5,BTC,-5,-1,2022,11,4
2022-11-09 07:01:10,12,17,0,21,3,BTC,18,17,2022,11,4
2022-11-09 19:12:20,3,3,0,4,0,BTC,4,3,2022,11,4
2022-11-10 15:25:11,6,8,0,9,0,BTC,9,8,2022,11,4
2022-11-10 18:00:00,3,4,0,3,0,BTC,3,4,2022,11,4
2022-11-10 19:11:28,6,7,0,9,2,BTC,7,7,2022,11,4
2022-11-11 02:33:07,17,3,8,0,23,BTC,-23,-5,2022,11,4
2022-11-11 15:30:53,5,8,0,9,0,BTC,9,8,2022,11,4
2022-11-11 19:00:00,12,16,1,16,0,BTC,16,15,2022,11,4
2022-11-12 12:45:35,5,7,0,10,0,BTC,10,7,2022,11,4
2022-11-12 13:02:10,3,3,0,5,0,BTC,5,3,2022,11,4
2022-11-13 18:10:18,6,8,4,5,2,BTC,3,4,2022,11,4
2022-11-14 07:22:59,18,29,2,45,2,BTC,43,27,2022,11,4
2022-11-14 09:03:05,6,10,1,9,1,BTC,8,9,2022,11,4
2022-11-14 10:48:00,15,5,5,9,5,BTC,4,0,2022,11,4
2022-11-14 18:54:14,5,6,0,8,0,BTC,8,6,2022,11,4
2022-11-14 21:00:13,8,15,0,13,1,BTC,12,15,2022,11,4
2022-11-15 12:05:00,5,4,0,6,0,BTC,6,4,2022,11,4
2022-11-16 23:00:03,5,5,12,10,14,BTC,-4,-7,2022,11,4
2022-11-16 23:00:06,5,3,2,9,8,BTC,1,1,2022,11,4
2022-11-17 16:08:35,7,16,4,22,9,BTC,13,12,2022,11,4
2022-11-18 10:07:28,4,3,1,3,5,BTC,-2,2,2022,11,4
2022-11-18 11:24:14,12,6,6,11,25,BTC,-14,0,2022,11,4
2022-11-18 18:39:08,11,9,0,2,1,BTC,1,9,2022,11,4
2022-11-18 21:19:53,3,0,1,0,0,BTC,0,-1,2022,11,4
2022-11-20 04:09:10,3,11,0,13,3,BTC,10,11,2022,11,4
2022-11-20 10:59:45,6,7,1,7,1,BTC,6,6,2022,11,4
2022-11-20 12:36:56,16,11,5,3,18,BTC,-15,6,2022,11,4
2022-11-20 15:30:39,15,1,9,2,15,BTC,-13,-8,2022,11,4
2022-11-20 19:45:24,4,0,5,1,2,BTC,-1,-5,2022,11,4
2022-11-20 20:00:04,10,14,3,15,14,BTC,1,11,2022,11,4
2022-11-21 14:05:00,4,2,4,1,6,BTC,-5,-2,2022,11,4
2022-11-21 16:03:57,9,6,2,1,9,BTC,-8,4,2022,11,4
2022-11-21 17:14:40,4,3,4,2,7,BTC,-5,-1,2022,11,4
2022-11-22 22:35:36,5,2,1,1,2,BTC,-1,1,2022,11,4
2022-11-23 12:25:49,4,0,4,0,6,BTC,-6,-4,2022,11,4
2022-11-23 13:54:09,6,8,0,7,0,BTC,7,8,2022,11,4
2022-11-23 23:05:55,7,7,2,7,10,BTC,-3,5,2022,11,4
2022-11-24 03:33:18,10,4,0,2,5,BTC,-3,4,2022,11,4
2022-11-25 05:58:06,9,14,0,14,0,BTC,14,14,2022,11,4
2022-11-25 08:25:38,3,2,0,0,4,BTC,-4,2,2022,11,4
2022-11-25 13:04:05,13,27,0,34,3,BTC,31,27,2022,11,4
2022-11-25 18:13:44,3,1,1,0,4,BTC,-4,0,2022,11,4
2022-11-25 20:30:40,4,6,0,6,0,BTC,6,6,2022,11,4
2022-11-26 11:04:33,3,2,0,0,3,BTC,-3,2,2022,11,4
2022-11-27 08:38:41,3,5,0,3,0,BTC,3,5,2022,11,4
2022-11-27 18:30:00,6,5,3,3,8,BTC,-5,2,2022,11,4
2022-11-28 15:34:06,3,0,0,0,4,BTC,-4,0,2022,11,4
2022-11-28 16:15:13,4,1,0,0,5,BTC,-5,1,2022,11,4
2022-11-28 16:39:42,7,5,3,1,11,BTC,-10,2,2022,11,4
2022-11-29 09:38:01,5,3,0,6,6,BTC,0,3,2022,11,4
2022-11-29 23:00:16,4,5,1,4,2,BTC,2,4,2022,11,4
2022-11-30 08:04:24,5,4,0,6,0,BTC,6,4,2022,11,4
2022-11-30 22:12:30,10,15,1,17,1,BTC,16,14,2022,11,4
2022-12-01 22:00:39,5,8,6,3,1,BTC,2,2,2022,12,4
2022-12-06 15:26:46,3,3,0,4,0,BTC,4,3,2022,12,4
2022-12-06 22:10:00,4,1,8,0,8,BTC,-8,-7,2022,12,4
2022-12-07 08:59:54,3,5,7,5,7,BTC,-2,-2,2022,12,4
2022-12-07 18:12:24,8,12,9,10,6,BTC,4,3,2022,12,4
2022-12-10 14:00:00,3,1,2,0,5,BTC,-5,-1,2022,12,4
2022-12-11 19:39:47,4,4,1,1,4,BTC,-3,3,2022,12,4
2022-12-12 19:36:23,3,5,0,4,0,BTC,4,5,2022,12,4
2022-12-12 23:00:01,9,10,3,10,4,BTC,6,7,2022,12,4
2022-12-13 10:24:38,3,3,0,1,1,BTC,0,3,2022,12,4
2022-12-13 13:39:22,14,26,1,33,1,BTC,32,25,2022,12,4
2022-12-15 10:36:13,5,3,3,3,2,BTC,1,0,2022,12,4
2022-12-15 10:57:24,6,8,0,11,0,BTC,11,8,2022,12,4
2022-12-15 12:49:52,7,4,1,8,0,BTC,8,3,2022,12,4
2022-12-15 19:05:59,6,7,1,9,0,BTC,9,6,2022,12,4
2022-12-16 20:26:43,5,6,0,5,0,BTC,5,6,2022,12,4
2022-12-17 15:30:11,3,6,2,7,6,BTC,1,4,2022,12,4
2022-12-18 23:05:14,4,5,0,5,4,BTC,1,5,2022,12,4
2022-12-19 05:55:44,3,4,1,5,2,BTC,3,3,2022,12,4
2022-12-20 18:00:54,3,1,0,2,0,BTC,2,1,2022,12,4
2022-12-21 05:25:44,3,5,2,4,5,BTC,-1,3,2022,12,4
2022-12-22 01:34:33,6,6,0,9,0,BTC,9,6,2022,12,4
2022-12-23 12:15:22,4,6,2,6,1,BTC,5,4,2022,12,4
2022-12-24 13:05:13,3,3,1,3,0,BTC,3,2,2022,12,4
2022-12-24 22:44:32,6,8,6,14,7,BTC,7,2,2022,12,4
2022-12-25 11:35:18,10,10,2,3,14,BTC,-11,8,2022,12,4
2022-12-25 13:51:59,4,3,1,5,1,BTC,4,2,2022,12,4
2022-12-25 13:58:33,4,1,1,0,4,BTC,-4,0,2022,12,4
2022-12-29 16:36:40,6,5,0,2,1,BTC,1,5,2022,12,4
2023-01-02 10:18:44,8,6,1,1,11,BTC,-10,5,2023,1,1
2023-01-05 13:00:00,4,5,3,5,3,BTC,2,2,2023,1,1
2023-01-06 21:00:21,3,3,0,5,0,BTC,5,3,2023,1,1
2023-01-08 16:21:53,8,9,1,9,3,BTC,6,8,2023,1,1
2023-01-09 09:08:39,8,13,1,14,1,BTC,13,12,2023,1,1
2023-01-09 14:22:09,6,7,1,6,1,BTC,5,6,2023,1,1
2023-01-12 19:39:49,9,15,0,17,0,BTC,17,15,2023,1,1
2023-01-14 20:00:00,5,7,1,8,1,BTC,7,6,2023,1,1
2023-01-15 20:44:50,6,8,1,13,0,BTC,13,7,2023,1,1
2023-01-16 14:36:30,4,9,0,8,0,BTC,8,9,2023,1,1
2023-01-18 16:13:20,14,9,10,7,22,BTC,-15,-1,2023,1,1
2023-01-20 07:08:53,3,2,1,0,5,BTC,-5,1,2023,1,1
2023-01-20 21:00:43,6,9,0,11,0,BTC,11,9,2023,1,1
2023-01-21 12:33:09,7,10,0,13,0,BTC,13,10,2023,1,1
2023-01-23 18:00:38,3,2,1,5,0,BTC,5,1,2023,1,1
2023-01-25 22:25:13,7,11,1,13,0,BTC,13,10,2023,1,1
2023-01-26 00:08:12,10,10,1,11,1,BTC,10,9,2023,1,1
2023-01-26 15:30:22,6,9,2,10,2,BTC,8,7,2023,1,1
2023-02-03 03:09:13,3,4,2,5,2,BTC,3,2,2023,2,1
2023-02-03 08:04:32,3,4,0,4,1,BTC,3,4,2023,2,1
2023-02-05 14:22:59,4,8,3,11,3,BTC,8,5,2023,2,1
2023-02-05 15:30:10,5,9,4,12,3,BTC,9,5,2023,2,1
2023-02-06 09:47:17,5,4,3,2,5,BTC,-3,1,2023,2,1
2023-02-06 13:00:26,4,4,2,3,3,BTC,0,2,2023,2,1
2023-02-09 19:41:39,4,2,0,0,4,BTC,-4,2,2023,2,1
2023-02-12 20:25:55,3,4,0,8,0,BTC,8,4,2023,2,1
2023-02-14 18:23:27,4,0,2,2,5,BTC,-3,-2,2023,2,1
2023-02-16 20:00:33,4,6,3,6,3,BTC,3,3,2023,2,1
2023-02-17 20:55:24,10,12,2,15,2,BTC,13,10,2023,2,1
2023-02-17 21:17:25,5,5,1,6,0,BTC,6,4,2023,2,1
2023-02-18 05:20:00,5,13,0,10,0,BTC,10,13,2023,2,1
2023-03-05 23:05:20,3,4,5,4,6,BTC,-2,-1,2023,3,1
2023-03-08 11:42:32,3,3,0,2,3,BTC,-1,3,2023,3,1
2023-03-09 11:22:50,3,0,2,2,3,BTC,-1,-2,2023,3,1
2023-03-10 11:57:25,3,6,2,12,1,BTC,11,4,2023,3,1
2023-03-10 18:20:20,7,6,6,4,12,BTC,-8,0,2023,3,1
2023-03-10 21:00:56,4,4,1,9,0,BTC,9,3,2023,3,1
2023-03-11 22:03:29,3,5,0,4,0,BTC,4,5,2023,3,1
2023-03-12 18:32:44,3,3,0,7,0,BTC,7,3,2023,3,1
2023-03-20 17:00:07,10,8,2,15,2,BTC,13,6,2023,3,1
2023-03-22 08:15:35,7,0,7,2,7,BTC,-5,-7,2023,3,1
2023-03-22 13:38:23,4,6,1,8,1,BTC,7,5,2023,3,1
2023-03-23 05:26:18,3,1,4,3,3,BTC,0,-3,2023,3,1
2023-03-31 22:05:18,3,3,0,4,0,BTC,4,3,2023,3,1
2023-04-03 18:27:13,5,9,9,9,15,BTC,-6,0,2023,4,2
2023-04-09 19:07:43,4,8,1,9,2,BTC,7,7,2023,4,2
2023-04-21 07:12:21,4,5,0,6,1,BTC,5,5,2023,4,2
2023-04-22 15:08:00,11,15,4,17,3,BTC,14,11,2023,4,2
2023-04-28 14:02:49,6,6,1,6,1,BTC,5,5,2023,4,2
2023-04-29 13:04:06,3,4,0,4,0,BTC,4,4,2023,4,2
2023-05-06 01:16:00,7,2,5,3,3,BTC,0,-3,2023,5,2
2023-05-07 16:32:30,7,5,3,5,5,BTC,0,2,2023,5,2
2023-05-09 14:00:49,13,14,1,14,1,BTC,13,13,2023,5,2
2023-05-10 15:10:00,5,5,1,4,1,BTC,3,4,2023,5,2
2023-05-17 01:25:11,8,6,1,10,1,BTC,9,5,2023,5,2
2023-05-21 14:55:45,3,4,1,4,0,BTC,4,3,2023,5,2
2023-05-24 15:45:00,6,6,0,6,0,BTC,6,6,2023,5,2
2023-05-28 12:38:00,4,3,2,3,3,BTC,0,1,2023,5,2
2023-05-28 22:25:52,6,9,0,11,0,BTC,11,9,2023,5,2
2023-05-30 15:16:04,4,4,0,6,0,BTC,6,4,2023,5,2
2023-05-31 21:00:59,5,0,2,1,3,BTC,-2,-2,2023,5,2
2023-06-01 22:01:01,3,2,1,3,1,BTC,2,1,2023,6,2
2023-06-04 20:00:00,10,11,4,12,3,BTC,9,7,2023,6,2
2023-06-07 22:00:29,3,5,0,4,0,BTC,4,5,2023,6,2
2023-06-13 11:27:37,3,2,0,2,0,BTC,2,2,2023,6,2
2023-06-16 22:00:52,5,7,0,7,0,BTC,7,7,2023,6,2
2023-06-18 13:50:46,6,8,0,8,0,BTC,8,8,2023,6,2
2023-06-20 08:46:23,5,9,1,6,0,BTC,6,8,2023,6,2
2023-06-21 03:49:35,8,6,3,9,7,BTC,2,3,2023,6,2
2023-06-21 07:04:47,5,7,2,8,1,BTC,7,5,2023,6,2
2023-06-22 02:35:45,5,8,0,7,0,BTC,7,8,2023,6,2
2023-06-22 03:13:59,5,10,0,9,0,BTC,9,10,2023,6,2
2023-06-22 10:51:17,4,10,0,9,0,BTC,9,10,2023,6,2
2023-06-22 14:12:25,5,5,0,5,1,BTC,4,5,2023,6,2
2023-06-24 17:08:19,4,2,1,3,5,BTC,-2,1,2023,6,2
2023-06-25 09:15:07,4,7,1,7,1,BTC,6,6,2023,6,2
2023-06-26 16:32:17,6,9,0,9,0,BTC,9,9,2023,6,2
2023-06-26 18:15:23,8,11,3,11,5,BTC,6,8,2023,6,2
2023-06-27 09:30:06,3,3,3,6,3,BTC,3,0,2023,6,2
2023-06-29 20:05:33,3,4,2,4,2,BTC,2,2,2023,6,2
2023-06-30 13:46:40,9,5,5,4,22,BTC,-18,0,2023,6,2
2023-06-30 14:45:21,4,1,1,1,3,BTC,-2,0,2023,6,2
2023-06-30 19:41:55,7,7,2,7,2,BTC,5,5,2023,6,2
2023-07-02 06:13:00,9,2,3,0,7,BTC,-7,-1,2023,7,3
2023-07-02 07:01:40,4,3,0,2,0,BTC,2,3,2023,7,3
2023-07-03 17:26:04,28,37,6,43,9,BTC,34,31,2023,7,3
2023-07-03 17:34:23,10,7,2,7,2,BTC,5,5,2023,7,3
2023-07-05 19:18:06,10,13,0,13,1,BTC,12,13,2023,7,3
2023-07-05 21:06:04,5,9,1,10,1,BTC,9,8,2023,7,3
2023-07-06 23:00:04,9,11,2,14,3,BTC,11,9,2023,7,3
2023-07-07 01:00:22,4,2,0,1,0,BTC,1,2,2023,7,3
2023-07-07 18:00:46,5,5,1,8,2,BTC,6,4,2023,7,3
2023-07-10 09:35:07,3,2,0,5,0,BTC,5,2,2023,7,3
2023-07-11 02:48:34,8,0,6,1,8,BTC,-7,-6,2023,7,3
2023-07-11 02:51:39,7,8,0,9,2,BTC,7,8,2023,7,3
2023-07-12 14:33:12,5,7,2,8,0,BTC,8,5,2023,7,3
2023-07-12 21:58:05,3,2,2,1,1,BTC,0,0,2023,7,3
2023-07-14 04:05:00,3,4,0,3,1,BTC,2,4,2023,7,3
2023-07-14 15:18:04,10,18,1,18,2,BTC,16,17,2023,7,3
2023-07-14 19:28:07,5,6,1,5,7,BTC,-2,5,2023,7,3
2023-07-15 14:18:05,12,16,0,13,0,BTC,13,16,2023,7,3
2023-07-17 12:02:07,10,10,2,13,2,BTC,11,8,2023,7,3
2023-07-17 14:08:06,4,0,0,0,2,BTC,-2,0,2023,7,3
2023-07-17 16:55:37,4,4,1,5,1,BTC,4,3,2023,7,3
2023-07-17 19:35:22,3,1,1,1,3,BTC,-2,0,2023,7,3
2023-07-18 01:01:37,9,12,4,9,4,BTC,5,8,2023,7,3
2023-07-18 18:15:46,11,13,1,17,1,BTC,16,12,2023,7,3
2023-07-19 00:47:00,3,4,2,5,2,BTC,3,2,2023,7,3
2023-07-19 14:39:05,5,3,1,1,5,BTC,-4,2,2023,7,3
2023-07-19 17:37:05,5,5,0,7,0,BTC,7,5,2023,7,3
2023-07-19 19:16:05,9,8,0,9,1,BTC,8,8,2023,7,3
2023-07-19 23:02:13,5,6,0,5,0,BTC,5,6,2023,7,3
2023-07-20 04:51:37,4,7,2,8,2,BTC,6,5,2023,7,3
2023-07-20 20:14:49,3,3,0,1,4,BTC,-3,3,2023,7,3
2023-07-21 01:23:24,6,7,2,9,1,BTC,8,5,2023,7,3
2023-07-21 13:00:00,5,2,4,2,2,BTC,0,-2,2023,7,3
2023-07-22 12:45:12,4,2,1,4,0,BTC,4,1,2023,7,3
2023-07-22 14:48:05,3,1,1,1,4,BTC,-3,0,2023,7,3
2023-07-23 13:30:21,4,5,0,5,0,BTC,5,5,2023,7,3
2023-07-24 12:17:06,3,3,1,4,0,BTC,4,2,2023,7,3
2023-07-25 04:46:27,3,3,1,3,1,BTC,2,2,2023,7,3
2023-07-25 16:18:05,5,5,0,8,0,BTC,8,5,2023,7,3
2023-07-25 20:15:15,4,6,0,6,0,BTC,6,6,2023,7,3
2023-07-27 13:35:00,3,3,0,3,0,BTC,3,3,2023,7,3
2023-07-27 15:45:04,5,4,1,1,2,BTC,-1,3,2023,7,3
2023-07-28 20:23:05,7,9,0,7,0,BTC,7,9,2023,7,3
2023-07-31 04:56:27,8,0,0,1,1,BTC,0,0,2023,7,3
2023-07-31 08:00:05,11,13,3,14,2,BTC,12,10,2023,7,3
2023-07-31 09:58:31,6,2,4,3,2,BTC,1,-2,2023,7,3
2023-08-02 14:35:33,3,4,1,4,3,BTC,1,3,2023,8,3
2023-08-02 15:21:05,3,3,2,2,3,BTC,-1,1,2023,8,3
2023-08-02 17:21:05,4,3,2,1,4,BTC,-3,1,2023,8,3
2023-08-03 03:00:01,5,1,8,1,8,BTC,-7,-7,2023,8,3
2023-08-04 15:39:05,4,4,0,4,0,BTC,4,4,2023,8,3
2023-08-04 21:00:41,3,4,0,3,0,BTC,3,4,2023,8,3
2023-08-05 08:51:18,7,8,0,8,1,BTC,7,8,2023,8,3
2023-08-06 19:05:24,7,8,0,8,0,BTC,8,8,2023,8,3
2023-08-07 10:35:18,3,3,0,3,0,BTC,3,3,2023,8,3
2023-08-07 14:14:47,3,4,0,5,0,BTC,5,4,2023,8,3
2023-08-07 17:48:37,4,3,2,7,1,BTC,6,1,2023,8,3
2023-08-08 12:29:05,4,1,3,2,5,BTC,-3,-2,2023,8,3
2023-08-08 20:36:03,5,5,5,3,6,BTC,-3,0,2023,8,3
2023-08-11 00:05:00,3,4,0,3,0,BTC,3,4,2023,8,3
2023-08-11 01:20:29,4,4,2,7,4,BTC,3,2,2023,8,3
2023-08-11 08:56:06,4,5,0,4,1,BTC,3,5,2023,8,3
2023-08-11 14:56:27,4,0,3,1,6,BTC,-5,-3,2023,8,3
2023-08-12 05:22:13,3,2,0,2,0,BTC,2,2,2023,8,3
2023-08-13 11:51:42,4,3,0,4,0,BTC,4,3,2023,8,3
2023-08-13 20:10:06,4,4,1,5,1,BTC,4,3,2023,8,3
2023-08-14 09:20:09,4,4,2,11,2,BTC,9,2,2023,8,3
2023-08-15 19:22:06,9,5,4,2,4,BTC,-2,1,2023,8,3
2023-08-15 20:00:06,5,6,1,8,1,BTC,7,5,2023,8,3
2023-08-16 10:58:42,8,11,2,15,1,BTC,14,9,2023,8,3
2023-08-16 17:16:06,5,4,1,7,1,BTC,6,3,2023,8,3
2023-08-17 20:17:05,8,7,3,1,12,BTC,-11,4,2023,8,3
2023-08-17 21:58:05,4,4,0,0,4,BTC,-4,4,2023,8,3
2023-08-17 23:02:03,17,17,4,19,2,BTC,17,13,2023,8,3
2023-08-18 01:33:15,5,1,2,1,5,BTC,-4,-1,2023,8,3
2023-08-18 14:58:05,5,6,1,0,8,BTC,-8,5,2023,8,3
2023-08-20 14:21:23,3,2,0,2,0,BTC,2,2,2023,8,3
2023-08-20 22:27:04,4,8,0,10,0,BTC,10,8,2023,8,3
2023-08-21 11:27:41,8,13,1,12,1,BTC,11,12,2023,8,3
2023-08-22 15:35:00,6,8,0,7,1,BTC,6,8,2023,8,3
2023-08-24 02:22:13,3,2,0,3,0,BTC,3,2,2023,8,3
2023-08-24 17:45:17,6,6,0,9,0,BTC,9,6,2023,8,3
2023-08-25 18:59:52,7,10,4,13,6,BTC,7,6,2023,8,3
2023-08-25 23:04:57,5,6,1,9,1,BTC,8,5,2023,8,3
2023-08-26 11:20:56,5,6,3,7,5,BTC,2,3,2023,8,3
2023-08-27 09:15:54,6,17,6,17,7,BTC,10,11,2023,8,3
2023-08-27 18:26:47,3,4,1,6,0,BTC,6,3,2023,8,3
2023-08-28 12:54:17,5,6,4,6,6,BTC,0,2,2023,8,3
2023-08-29 14:25:06,37,57,1,77,1,BTC,76,56,2023,8,3
2023-08-29 15:17:54,18,30,1,38,1,BTC,37,29,2023,8,3
2023-08-29 19:06:58,8,12,2,17,1,BTC,16,10,2023,8,3
2023-08-31 03:00:01,8,11,1,20,2,BTC,18,10,2023,8,3
2023-08-31 19:16:03,9,4,3,1,10,BTC,-9,1,2023,8,3
2023-08-31 22:03:36,12,17,10,20,13,BTC,7,7,2023,8,3
2023-09-01 16:37:05,4,5,0,8,1,BTC,7,5,2023,9,3
2023-09-04 13:18:05,6,6,0,8,0,BTC,8,6,2023,9,3
2023-09-07 15:15:00,3,2,7,0,9,BTC,-9,-5,2023,9,3
2023-09-07 21:29:06,5,5,1,8,1,BTC,7,4,2023,9,3
2023-09-11 13:27:06,3,2,0,1,4,BTC,-3,2,2023,9,3
2023-09-11 16:11:33,4,1,1,0,5,BTC,-5,0,2023,9,3
2023-09-11 17:14:06,7,4,5,1,3,BTC,-2,-1,2023,9,3
2023-09-11 20:05:07,3,3,0,0,4,BTC,-4,3,2023,9,3
2023-09-12 09:51:18,3,4,2,9,2,BTC,7,2,2023,9,3
2023-09-12 20:02:09,3,6,2,5,1,BTC,4,4,2023,9,3
2023-09-13 12:32:06,3,2,0,1,5,BTC,-4,2,2023,9,3
2023-09-13 16:33:06,4,1,0,1,0,BTC,1,1,2023,9,3
2023-09-13 17:31:04,8,4,3,2,14,BTC,-12,1,2023,9,3
2023-09-14 12:34:06,4,5,0,2,4,BTC,-2,5,2023,9,3
2023-09-14 20:06:07,6,8,0,7,1,BTC,6,8,2023,9,3
2023-09-15 17:59:45,6,21,1,24,0,BTC,24,20,2023,9,3
2023-09-16 12:05:00,4,3,1,2,0,BTC,2,2,2023,9,3
2023-09-16 13:19:56,11,17,1,25,1,BTC,24,16,2023,9,3
2023-09-17 19:04:08,3,3,0,3,0,BTC,3,3,2023,9,3
2023-09-18 13:48:53,4,6,0,7,0,BTC,7,6,2023,9,3
2023-09-19 19:13:07,5,6,1,6,0,BTC,6,5,2023,9,3
2023-09-19 20:21:04,4,4,0,5,0,BTC,5,4,2023,9,3
2023-09-20 09:53:06,4,4,0,5,1,BTC,4,4,2023,9,3
2023-09-21 14:00:17,3,5,1,7,0,BTC,7,4,2023,9,3
2023-09-22 18:19:07,4,3,0,5,0,BTC,5,3,2023,9,3
2023-09-25 00:00:45,3,4,1,3,1,BTC,2,3,2023,9,3
2023-09-25 10:48:31,7,6,0,4,2,BTC,2,6,2023,9,3
2023-09-25 12:01:37,3,3,0,1,2,BTC,-1,3,2023,9,3
2023-09-25 14:52:43,3,3,0,3,0,BTC,3,3,2023,9,3
2023-09-25 17:00:32,3,5,7,8,7,BTC,1,-2,2023,9,3
2023-09-26 08:38:07,3,3,0,0,3,BTC,-3,3,2023,9,3
2023-09-26 09:29:13,3,3,0,3,0,BTC,3,3,2023,9,3
2023-09-26 13:19:10,3,3,0,3,0,BTC,3,3,2023,9,3
2023-09-26 19:44:03,14,18,0,26,0,BTC,26,18,2023,9,3
2023-09-27 09:07:08,3,3,0,3,0,BTC,3,3,2023,9,3
2023-09-28 22:01:00,3,3,1,4,0,BTC,4,2,2023,9,3
2023-09-29 08:21:45,6,7,0,9,0,BTC,9,7,2023,9,3
2023-09-29 13:29:12,4,4,0,4,0,BTC,4,4,2023,9,3
2023-09-29 17:40:38,5,4,0,7,0,BTC,7,4,2023,9,3
2023-09-30 12:51:39,6,5,0,0,6,BTC,-6,5,2023,9,3
2023-09-30 13:27:58,3,6,0,6,0,BTC,6,6,2023,9,3
2023-10-01 12:28:13,3,3,0,3,0,BTC,3,3,2023,10,4
2023-10-01 14:14:22,8,6,1,5,0,BTC,5,5,2023,10,4
2023-10-01 22:33:04,14,15,1,18,2,BTC,16,14,2023,10,4
2023-10-02 09:09:24,3,3,0,3,0,BTC,3,3,2023,10,4
2023-10-02 09:21:33,3,3,0,3,0,BTC,3,3,2023,10,4
2023-10-02 10:37:18,3,3,0,3,0,BTC,3,3,2023,10,4
2023-10-02 12:20:17,3,3,0,3,0,BTC,3,3,2023,10,4
2023-10-02 13:26:55,3,3,0,0,3,BTC,-3,3,2023,10,4
2023-10-02 15:08:42,14,18,0,17,0,BTC,17,18,2023,10,4
2023-10-03 08:18:16,3,3,0,3,0,BTC,3,3,2023,10,4
2023-10-04 09:57:30,6,8,0,8,0,BTC,8,8,2023,10,4
2023-10-04 12:25:09,5,7,0,8,0,BTC,8,7,2023,10,4
2023-10-04 12:27:20,3,3,0,0,4,BTC,-4,3,2023,10,4
2023-10-04 14:03:47,4,5,0,7,0,BTC,7,5,2023,10,4
2023-10-04 16:58:36,4,6,0,3,1,BTC,2,6,2023,10,4
2023-10-05 08:50:24,3,4,0,4,0,BTC,4,4,2023,10,4
2023-10-05 12:40:31,3,3,0,3,0,BTC,3,3,2023,10,4
2023-10-05 14:55:02,3,3,0,3,0,BTC,3,3,2023,10,4
2023-10-07 09:49:10,3,5,0,5,0,BTC,5,5,2023,10,4
2023-10-07 11:03:34,3,6,0,5,0,BTC,5,6,2023,10,4
2023-10-08 09:14:23,5,3,1,1,3,BTC,-2,2,2023,10,4
2023-10-09 09:25:01,3,3,0,3,0,BTC,3,3,2023,10,4
2023-10-09 11:00:33,3,3,0,1,3,BTC,-2,3,2023,10,4
2023-10-09 11:31:06,7,10,2,8,0,BTC,8,8,2023,10,4
2023-10-10 08:47:24,4,4,3,1,5,BTC,-4,1,2023,10,4
2023-10-11 13:30:23,3,3,0,3,0,BTC,3,3,2023,10,4
2023-10-12 08:35:53,3,3,0,4,0,BTC,4,3,2023,10,4
2023-10-13 20:00:46,5,6,0,8,0,BTC,8,6,2023,10,4
2023-10-13 20:58:04,25,41,0,51,3,BTC,48,41,2023,10,4
2023-10-13 21:00:09,3,4,4,1,6,BTC,-5,0,2023,10,4
2023-10-14 09:18:26,3,3,0,3,1,BTC,2,3,2023,10,4
2023-10-14 10:20:34,4,3,1,1,3,BTC,-2,2,2023,10,4
2023-10-14 10:20:46,9,9,0,10,0,BTC,10,9,2023,10,4
2023-10-15 11:00:23,3,7,2,5,0,BTC,5,5,2023,10,4
2023-10-16 10:44:14,3,4,1,3,1,BTC,2,3,2023,10,4
2023-10-16 11:45:17,3,5,0,4,0,BTC,4,5,2023,10,4
2023-10-16 13:32:04,7,10,4,12,3,BTC,9,6,2023,10,4
2023-10-16 14:00:22,3,0,0,0,1,BTC,-1,0,2023,10,4
2023-10-16 14:07:56,16,5,0,1,8,BTC,-7,5,2023,10,4
2023-10-16 15:10:06,7,1,1,0,1,BTC,-1,0,2023,10,4
2023-10-16 20:52:40,10,11,0,13,2,BTC,11,11,2023,10,4
2023-10-17 01:39:12,10,16,1,15,1,BTC,14,15,2023,10,4
2023-10-17 08:53:09,3,3,0,3,0,BTC,3,3,2023,10,4
2023-10-17 09:45:15,3,3,0,3,0,BTC,3,3,2023,10,4
2023-10-18 08:44:57,3,3,1,3,1,BTC,2,2,2023,10,4
2023-10-18 12:25:42,4,5,1,5,1,BTC,4,4,2023,10,4
2023-10-18 16:08:59,3,2,7,7,5,BTC,2,-5,2023,10,4
2023-10-19 08:40:03,3,3,0,3,0,BTC,3,3,2023,10,4
2023-10-19 10:10:53,3,3,1,3,1,BTC,2,2,2023,10,4
2023-10-21 10:26:57,4,4,0,5,0,BTC,5,4,2023,10,4
2023-10-21 13:44:47,3,3,0,3,1,BTC,2,3,2023,10,4
2023-10-21 16:05:00,3,2,0,3,1,BTC,2,2,2023,10,4
2023-10-21 19:16:05,3,4,0,6,1,BTC,5,4,2023,10,4
2023-10-22 10:33:41,3,3,0,1,2,BTC,-1,3,2023,10,4
2023-10-22 11:50:16,5,5,0,6,0,BTC,6,5,2023,10,4
2023-10-22 19:03:58,3,1,0,1,0,BTC,1,1,2023,10,4
2023-10-22 23:15:00,3,5,0,4,0,BTC,4,5,2023,10,4
